Zeit;FahrradbrueckeFahrradbruecke;FahrradbrueckeFahrradbruecke stadteinwärts Fahrräder;FahrradbrueckeFahrradbruecke stadtauswärts Fahrräder;Symbol Wetter;Temperatur (°C);Gefühlte Temperatur (°C);Regen (mm)
01.01.2020 00:00;104;31;73;Leicht bewölkt;1;-1;0
01.01.2020 01:00;128;47;81;Leicht bewölkt;0;-1;0
01.01.2020 02:00;178;77;101;Sonnig;0;-2;0
01.01.2020 03:00;113;56;57;Sonnig;0;-2;0
01.01.2020 04:00;76;36;40;Sonnig;0;-2;0
01.01.2020 05:00;50;12;38;Sonnig;0;-2;0
01.01.2020 06:00;25;14;11;Sonnig;-1;-3;0
01.01.2020 07:00;19;6;13;Sonnig;0;-2;0
01.01.2020 08:00;23;11;12;Sonnig;1;-1;0
01.01.2020 09:00;27;13;14;Sonnig;1;0;0
01.01.2020 10:00;36;21;15;Sonnig;3;1;0
01.01.2020 11:00;56;23;33;Sonnig;4;3;0
01.01.2020 12:00;76;33;43;Sonnig;5;5;0
01.01.2020 13:00;75;41;34;Sonnig;5;4;0
01.01.2020 14:00;91;40;51;Sonnig;5;4;0
01.01.2020 15:00;116;64;52;Sonnig;5;4;0
01.01.2020 16:00;115;50;65;Sonnig;4;3;0
01.01.2020 17:00;88;42;46;Sonnig;3;3;0
01.01.2020 18:00;97;36;61;Sonnig;2;2;0
01.01.2020 19:00;80;40;40;Sonnig;2;2;0
01.01.2020 20:00;61;30;31;Sonnig;1;1;0
01.01.2020 21:00;42;21;21;Sonnig;1;1;0
01.01.2020 22:00;34;13;21;Sonnig;1;1;0
01.01.2020 23:00;33;19;14;Sonnig;1;1;0
02.01.2020 00:00;18;5;13;Sonnig;1;1;0
02.01.2020 01:00;6;2;4;Sonnig;0;0;0
02.01.2020 02:00;4;1;3;Sonnig;0;0;0
02.01.2020 03:00;2;1;1;Sonnig;0;0;0
02.01.2020 04:00;10;5;5;Sonnig;0;0;0
02.01.2020 05:00;19;8;11;Sonnig;0;0;0
02.01.2020 06:00;58;41;17;Sonnig;0;0;0
02.01.2020 07:00;138;80;58;Sonnig;0;0;0
02.01.2020 08:00;187;112;75;Sonnig;1;1;0
02.01.2020 09:00;202;134;68;Sonnig;2;2;0
02.01.2020 10:00;202;131;71;Sonnig;4;4;0
02.01.2020 11:00;308;174;134;Sonnig;5;5;0
02.01.2020 12:00;275;120;155;Sonnig;6;6;0
02.01.2020 13:00;319;152;167;Sonnig;6;6;0
02.01.2020 14:00;322;165;157;Sonnig;5;5;0
02.01.2020 15:00;358;167;191;Sonnig;4;5;0
02.01.2020 16:00;323;159;164;Sonnig;4;4;0
02.01.2020 17:00;343;151;192;Leicht bewölkt;3;3;0
02.01.2020 18:00;277;117;160;Leicht bewölkt;2;2;0
02.01.2020 19:00;229;87;142;Leicht bewölkt;2;2;0
02.01.2020 20:00;136;58;78;Leicht bewölkt;1;1;0
02.01.2020 21:00;100;51;49;Leicht bewölkt;1;1;0
02.01.2020 22:00;113;45;68;Leicht bewölkt;1;0;0
02.01.2020 23:00;89;41;48;Leicht bewölkt;1;0;0
03.01.2020 00:00;44;17;27;Leicht bewölkt;0;0;0
03.01.2020 01:00;34;7;27;Leicht bewölkt;0;0;0
03.01.2020 02:00;13;7;6;Leicht bewölkt;0;0;0
03.01.2020 03:00;3;2;1;Leicht bewölkt;0;0;0
03.01.2020 04:00;10;4;6;Leicht bewölkt;0;-1;0
03.01.2020 05:00;26;14;12;Bewölkt;0;-1;0
03.01.2020 06:00;83;54;29;Bewölkt;0;-1;0
03.01.2020 07:00;127;74;53;Bewölkt;0;0;0
03.01.2020 08:00;199;130;69;Bedeckt;1;1;0
03.01.2020 09:00;233;147;86;Bedeckt;2;2;0
03.01.2020 10:00;291;156;135;Bedeckt;3;2;0
03.01.2020 11:00;392;228;164;Bedeckt;5;3;0
03.01.2020 12:00;344;153;191;Bedeckt;6;4;0
03.01.2020 13:00;340;152;188;Bedeckt;6;4;0
03.01.2020 14:00;379;191;188;Bedeckt;5;3;0
03.01.2020 15:00;369;178;191;Bedeckt;5;3;0
03.01.2020 16:00;351;164;187;Bedeckt;5;2;0
03.01.2020 17:00;358;159;199;Bewölkt;4;2;0
03.01.2020 18:00;292;124;168;Bewölkt;4;1;0
03.01.2020 19:00;221;99;122;Bewölkt;3;1;0
03.01.2020 20:00;129;57;72;Bedeckt;2;1;2
03.01.2020 21:00;102;47;55;Bedeckt;1;0;3
03.01.2020 22:00;78;28;50;Bedeckt;2;1;1
03.01.2020 23:00;69;28;41;Leichter Regenfall;2;1;1
04.01.2020 00:00;75;20;55;Leichter Regenfall;3;1;2
04.01.2020 01:00;34;5;29;Leichter Regenfall;4;2;1
04.01.2020 02:00;40;13;27;Bedeckt;4;2;1
04.01.2020 03:00;14;5;9;Bedeckt;5;2;2
04.01.2020 04:00;5;2;3;Bedeckt;5;2;1
04.01.2020 05:00;16;10;6;Nieselregen;5;2;2
04.01.2020 06:00;26;16;10;Nieselregen;5;2;2
04.01.2020 07:00;39;27;12;Nieselregen;5;2;1
04.01.2020 08:00;86;44;42;Nieselregen;5;2;1
04.01.2020 09:00;131;88;43;Nieselregen;5;3;2
04.01.2020 10:00;177;103;74;Nieselregen;5;3;1
04.01.2020 11:00;241;126;115;Nieselregen;5;3;2
04.01.2020 12:00;303;165;138;Nieselregen;5;3;2
04.01.2020 13:00;288;148;140;Nieselregen;5;3;1
04.01.2020 14:00;303;132;171;Nieselregen;5;3;1
04.01.2020 15:00;252;134;118;Nieselregen;5;3;1
04.01.2020 16:00;306;151;155;Nieselregen;4;3;0
04.01.2020 17:00;252;120;132;Stellenweiser Regenfall;4;2;0
04.01.2020 18:00;272;128;144;Stellenweiser Regenfall;3;2;0
04.01.2020 19:00;201;104;97;Stellenweiser Regenfall;3;2;0
04.01.2020 20:00;153;73;80;Bedeckt;3;1;0
04.01.2020 21:00;119;71;48;Bedeckt;3;1;0
04.01.2020 22:00;89;48;41;Bedeckt;2;1;0
04.01.2020 23:00;79;30;49;Leicht bewölkt;2;1;0
05.01.2020 00:00;80;20;60;Leicht bewölkt;2;1;0
05.01.2020 01:00;58;9;49;Leicht bewölkt;1;1;0
05.01.2020 02:00;39;10;29;Leicht bewölkt;1;1;0
05.01.2020 03:00;25;6;19;Leicht bewölkt;1;1;0
05.01.2020 04:00;15;5;10;Leicht bewölkt;1;1;0
05.01.2020 05:00;14;6;8;Leicht bewölkt;1;1;0
05.01.2020 06:00;18;12;6;Leicht bewölkt;1;1;0
05.01.2020 07:00;15;8;7;Leicht bewölkt;1;1;0
05.01.2020 08:00;41;20;21;Leicht bewölkt;2;2;0
05.01.2020 09:00;102;50;52;Leicht bewölkt;2;2;0
05.01.2020 10:00;110;59;51;Leicht bewölkt;3;2;0
05.01.2020 11:00;164;70;94;Leicht bewölkt;3;3;0
05.01.2020 12:00;223;105;118;Leicht bewölkt;4;3;0
05.01.2020 13:00;283;137;146;Leicht bewölkt;4;3;0
05.01.2020 14:00;255;110;145;Leicht bewölkt;4;3;0
05.01.2020 15:00;252;140;112;Leicht bewölkt;5;3;0
05.01.2020 16:00;253;122;131;Leicht bewölkt;4;2;0
05.01.2020 17:00;205;118;87;Leicht bewölkt;3;1;0
05.01.2020 18:00;205;115;90;Leicht bewölkt;2;0;0
05.01.2020 19:00;164;93;71;Leicht bewölkt;2;0;0
05.01.2020 20:00;135;60;75;Leicht bewölkt;1;-1;0
05.01.2020 21:00;91;47;44;Leicht bewölkt;1;-1;0
05.01.2020 22:00;94;34;60;Leicht bewölkt;0;-1;0
05.01.2020 23:00;76;28;48;Leicht bewölkt;0;-1;0
06.01.2020 00:00;35;20;15;Leicht bewölkt;0;-1;0
06.01.2020 01:00;22;9;13;Leicht bewölkt;0;-1;0
06.01.2020 02:00;14;4;10;Leicht bewölkt;0;-1;0
06.01.2020 03:00;10;5;5;Leicht bewölkt;0;-1;0
06.01.2020 04:00;12;7;5;Leicht bewölkt;0;-1;0
06.01.2020 05:00;28;17;11;Leicht bewölkt;0;-1;0
06.01.2020 06:00;66;60;6;Leicht bewölkt;0;-1;0
06.01.2020 07:00;57;47;10;Leicht bewölkt;0;0;0
06.01.2020 08:00;75;42;33;Leicht bewölkt;1;0;0
06.01.2020 09:00;119;67;52;Leicht bewölkt;1;1;0
06.01.2020 10:00;125;68;57;Leicht bewölkt;3;3;0
06.01.2020 11:00;136;60;76;Leicht bewölkt;4;4;0
06.01.2020 12:00;174;81;93;Leicht bewölkt;6;6;0
06.01.2020 13:00;179;93;86;Leicht bewölkt;6;6;0
06.01.2020 14:00;208;96;112;Leicht bewölkt;6;6;0
06.01.2020 15:00;195;94;101;Leicht bewölkt;6;6;0
06.01.2020 16:00;265;114;151;Leicht bewölkt;5;5;0
06.01.2020 17:00;279;136;143;Sonnig;5;5;0
06.01.2020 18:00;250;107;143;Sonnig;4;4;0
06.01.2020 19:00;227;108;119;Sonnig;4;3;0
06.01.2020 20:00;151;67;84;Sonnig;3;2;0
06.01.2020 21:00;108;41;67;Sonnig;2;1;0
06.01.2020 22:00;94;38;56;Sonnig;2;1;0
06.01.2020 23:00;65;24;41;Leicht bewölkt;1;0;0
07.01.2020 00:00;27;15;12;Leicht bewölkt;1;-1;0
07.01.2020 01:00;14;3;11;Leicht bewölkt;1;-1;0
07.01.2020 02:00;2;2;0;Leicht bewölkt;1;-1;0
07.01.2020 03:00;7;5;2;Leicht bewölkt;1;-1;0
07.01.2020 04:00;6;2;4;Leicht bewölkt;1;-1;0
07.01.2020 05:00;40;28;12;Leicht bewölkt;1;-1;0
07.01.2020 06:00;178;114;64;Leicht bewölkt;2;-1;0
07.01.2020 07:00;949;595;354;Leicht bewölkt;2;0;0
07.01.2020 08:00;766;459;307;Bewölkt;3;1;1
07.01.2020 09:00;645;405;240;Bewölkt;4;2;1
07.01.2020 10:00;323;175;148;Bewölkt;4;3;0
07.01.2020 11:00;523;253;270;Nieselregen;5;3;0
07.01.2020 12:00;510;219;291;Nieselregen;6;4;0
07.01.2020 13:00;755;341;414;Nieselregen;5;4;0
07.01.2020 14:00;515;265;250;Leicht bewölkt;5;4;0
07.01.2020 15:00;859;387;472;Leicht bewölkt;5;5;0
07.01.2020 16:00;722;360;362;Leicht bewölkt;4;4;0
07.01.2020 17:00;915;387;528;Leicht bewölkt;4;3;0
07.01.2020 18:00;716;292;424;Leicht bewölkt;3;3;0
07.01.2020 19:00;539;231;308;Leicht bewölkt;2;2;0
07.01.2020 20:00;329;135;194;Leicht bewölkt;1;1;0
07.01.2020 21:00;193;69;124;Leicht bewölkt;0;0;0
07.01.2020 22:00;190;81;109;Leicht bewölkt;0;0;0
07.01.2020 23:00;45;19;26;Leicht bewölkt;0;0;0
08.01.2020 00:00;37;11;26;Leicht bewölkt;-1;-1;0
08.01.2020 01:00;16;5;11;Leicht bewölkt;-1;-1;0
08.01.2020 02:00;6;2;4;Leicht bewölkt;-1;-1;0
08.01.2020 03:00;2;1;1;Leicht bewölkt;-1;-2;0
08.01.2020 04:00;7;4;3;Leicht bewölkt;-1;-2;0
08.01.2020 05:00;47;33;14;Leicht bewölkt;-1;-2;0
08.01.2020 06:00;167;110;57;Leicht bewölkt;-1;-2;0
08.01.2020 07:00;979;617;362;Leicht bewölkt;0;-1;0
08.01.2020 08:00;722;420;302;Leicht bewölkt;1;0;0
08.01.2020 09:00;649;383;266;Leicht bewölkt;1;1;0
08.01.2020 10:00;362;219;143;Leicht bewölkt;2;2;0
08.01.2020 11:00;500;230;270;Leicht bewölkt;4;3;0
08.01.2020 12:00;552;257;295;Leicht bewölkt;5;4;0
08.01.2020 13:00;784;384;400;Leicht bewölkt;5;4;0
08.01.2020 14:00;510;258;252;Leicht bewölkt;4;4;0
08.01.2020 15:00;724;307;417;Leicht bewölkt;4;4;0
08.01.2020 16:00;673;267;406;Leicht bewölkt;3;3;0
08.01.2020 17:00;859;376;483;Leicht bewölkt;3;2;0
08.01.2020 18:00;677;315;362;Leicht bewölkt;2;2;0
08.01.2020 19:00;541;241;300;Leicht bewölkt;2;1;0
08.01.2020 20:00;379;162;217;Leicht bewölkt;2;1;0
08.01.2020 21:00;220;93;127;Leicht bewölkt;2;1;0
08.01.2020 22:00;202;90;112;Leicht bewölkt;1;1;0
08.01.2020 23:00;102;37;65;Leicht bewölkt;1;1;0
09.01.2020 00:00;53;11;42;Leicht bewölkt;1;1;0
09.01.2020 01:00;23;4;19;Leicht bewölkt;1;1;0
09.01.2020 02:00;5;3;2;Leicht bewölkt;1;1;0
09.01.2020 03:00;3;2;1;Leicht bewölkt;1;1;0
09.01.2020 04:00;7;3;4;Leicht bewölkt;1;1;0
09.01.2020 05:00;49;33;16;Leicht bewölkt;1;1;0
09.01.2020 06:00;153;90;63;Leicht bewölkt;1;1;0
09.01.2020 07:00;925;586;339;Leicht bewölkt;2;2;0
09.01.2020 08:00;724;426;298;Leicht bewölkt;2;2;0
09.01.2020 09:00;670;424;246;Leicht bewölkt;3;3;0
09.01.2020 10:00;415;230;185;Leicht bewölkt;4;4;0
09.01.2020 11:00;508;258;250;Leicht bewölkt;6;6;0
09.01.2020 12:00;517;220;297;Leicht bewölkt;7;7;0
09.01.2020 13:00;723;281;442;Leicht bewölkt;7;7;0
09.01.2020 14:00;551;251;300;Leicht bewölkt;7;7;0
09.01.2020 15:00;836;428;408;Leicht bewölkt;7;7;0
09.01.2020 16:00;772;330;442;Leicht bewölkt;5;5;0
09.01.2020 17:00;915;373;542;Leicht bewölkt;4;4;0
09.01.2020 18:00;740;311;429;Leicht bewölkt;3;3;0
09.01.2020 19:00;522;228;294;Leicht bewölkt;3;3;0
09.01.2020 20:00;338;152;186;Bedeckt;2;2;0
09.01.2020 21:00;224;93;131;Bedeckt;1;1;0
09.01.2020 22:00;210;83;127;Bedeckt;1;1;0
09.01.2020 23:00;109;48;61;Leicht bewölkt;2;1;0
10.01.2020 00:00;42;9;33;Leicht bewölkt;2;1;0
10.01.2020 01:00;37;13;24;Leicht bewölkt;2;0;0
10.01.2020 02:00;11;5;6;Leicht bewölkt;2;0;0
10.01.2020 03:00;8;3;5;Leicht bewölkt;2;-1;0
10.01.2020 04:00;3;2;1;Leicht bewölkt;2;-1;0
10.01.2020 05:00;64;50;14;Bewölkt;2;-1;0
10.01.2020 06:00;148;86;62;Bewölkt;2;-1;0
10.01.2020 07:00;827;496;331;Bewölkt;3;0;0
10.01.2020 08:00;648;388;260;Leicht bewölkt;3;1;0
10.01.2020 09:00;643;384;259;Leicht bewölkt;4;2;0
10.01.2020 10:00;443;255;188;Leicht bewölkt;5;3;0
10.01.2020 11:00;556;273;283;Leicht bewölkt;6;4;0
10.01.2020 12:00;644;297;347;Leicht bewölkt;8;5;0
10.01.2020 13:00;801;356;445;Leicht bewölkt;8;5;0
10.01.2020 14:00;672;311;361;Bewölkt;8;5;0
10.01.2020 15:00;684;327;357;Bewölkt;8;6;0
10.01.2020 16:00;621;271;350;Bewölkt;7;5;0
10.01.2020 17:00;693;313;380;Stellenweiser Regenfall;6;4;0
10.01.2020 18:00;584;264;320;Stellenweiser Regenfall;6;4;0
10.01.2020 19:00;420;207;213;Stellenweiser Regenfall;6;4;0
10.01.2020 20:00;277;133;144;Bewölkt;5;3;0
10.01.2020 21:00;206;100;106;Bewölkt;5;3;0
10.01.2020 22:00;166;55;111;Bewölkt;5;4;0
10.01.2020 23:00;159;52;107;Nieselregen;5;4;0
11.01.2020 00:00;155;55;100;Nieselregen;5;4;1
11.01.2020 01:00;90;14;76;Nieselregen;5;4;0
11.01.2020 02:00;39;10;29;Bedeckt;5;5;1
11.01.2020 03:00;30;13;17;Bedeckt;5;5;1
11.01.2020 04:00;13;5;8;Bedeckt;4;4;0
11.01.2020 05:00;41;27;14;Nieselregen;4;4;1
11.01.2020 06:00;35;27;8;Nieselregen;4;3;1
11.01.2020 07:00;60;30;30;Nieselregen;4;4;0
11.01.2020 08:00;150;78;72;Nieselregen;4;4;0
11.01.2020 09:00;298;181;117;Nieselregen;4;4;0
11.01.2020 10:00;365;217;148;Nieselregen;5;5;0
11.01.2020 11:00;437;227;210;Leicht bewölkt;6;6;0
11.01.2020 12:00;544;314;230;Leicht bewölkt;7;6;0
11.01.2020 13:00;467;261;206;Leicht bewölkt;7;6;0
11.01.2020 14:00;498;260;238;Leicht bewölkt;7;6;0
11.01.2020 15:00;507;250;257;Leicht bewölkt;6;6;0
11.01.2020 16:00;466;211;255;Leicht bewölkt;5;5;0
11.01.2020 17:00;440;202;238;Leicht bewölkt;4;4;0
11.01.2020 18:00;404;151;253;Leicht bewölkt;4;3;0
11.01.2020 19:00;347;167;180;Leicht bewölkt;3;2;0
11.01.2020 20:00;275;121;154;Leicht bewölkt;2;2;0
11.01.2020 21:00;232;137;95;Leicht bewölkt;1;1;0
11.01.2020 22:00;186;83;103;Leicht bewölkt;1;1;0
11.01.2020 23:00;162;70;92;Leicht bewölkt;1;0;0
12.01.2020 00:00;96;40;56;Leicht bewölkt;0;0;0
12.01.2020 01:00;117;34;83;Leicht bewölkt;0;0;0
12.01.2020 02:00;85;31;54;Leicht bewölkt;0;0;0
12.01.2020 03:00;54;18;36;Leicht bewölkt;0;-1;0
12.01.2020 04:00;15;4;11;Leicht bewölkt;0;-1;0
12.01.2020 05:00;13;4;9;Leicht bewölkt;-1;-1;0
12.01.2020 06:00;28;18;10;Leicht bewölkt;-1;-1;0
12.01.2020 07:00;37;20;17;Leicht bewölkt;0;-1;0
12.01.2020 08:00;71;29;42;Leicht bewölkt;1;0;0
12.01.2020 09:00;159;78;81;Leicht bewölkt;2;1;0
12.01.2020 10:00;188;94;94;Leicht bewölkt;3;2;0
12.01.2020 11:00;213;117;96;Leicht bewölkt;4;3;0
12.01.2020 12:00;258;128;130;Leicht bewölkt;5;4;0
12.01.2020 13:00;275;154;121;Leicht bewölkt;5;4;0
12.01.2020 14:00;313;153;160;Bewölkt;5;4;0
12.01.2020 15:00;259;103;156;Bewölkt;5;4;0
12.01.2020 16:00;367;160;207;Bewölkt;4;3;0
12.01.2020 17:00;265;113;152;Bedeckt;3;2;0
12.01.2020 18:00;239;127;112;Bedeckt;3;1;0
12.01.2020 19:00;190;96;94;Bedeckt;2;1;0
12.01.2020 20:00;164;92;72;Bedeckt;2;1;0
12.01.2020 21:00;93;38;55;Bedeckt;1;0;0
12.01.2020 22:00;99;36;63;Bedeckt;1;0;0
12.01.2020 23:00;71;26;45;Bedeckt;1;1;0
13.01.2020 00:00;26;6;20;Bedeckt;1;1;0
13.01.2020 01:00;15;3;12;Bedeckt;1;0;0
13.01.2020 02:00;3;1;2;Bedeckt;0;0;0
13.01.2020 03:00;4;4;0;Bedeckt;0;0;0
13.01.2020 04:00;3;2;1;Bedeckt;0;0;0
13.01.2020 05:00;50;33;17;Leicht bewölkt;0;0;0
13.01.2020 06:00;180;111;69;Leicht bewölkt;-1;-1;0
13.01.2020 07:00;889;548;341;Leicht bewölkt;0;0;0
13.01.2020 08:00;694;424;270;Leicht bewölkt;1;1;0
13.01.2020 09:00;616;386;230;Leicht bewölkt;1;1;0
13.01.2020 10:00;355;203;152;Leicht bewölkt;3;3;0
13.01.2020 11:00;475;255;220;Leicht bewölkt;4;4;0
13.01.2020 12:00;454;198;256;Leicht bewölkt;5;5;0
13.01.2020 13:00;753;359;394;Leicht bewölkt;5;5;0
13.01.2020 14:00;529;231;298;Leicht bewölkt;5;5;0
13.01.2020 15:00;819;364;455;Leicht bewölkt;5;5;0
13.01.2020 16:00;702;339;363;Leicht bewölkt;4;4;0
13.01.2020 17:00;886;395;491;Leicht bewölkt;3;3;0
13.01.2020 18:00;698;302;396;Leicht bewölkt;2;2;0
13.01.2020 19:00;569;251;318;Leicht bewölkt;1;1;0
13.01.2020 20:00;369;159;210;Leicht bewölkt;0;0;0
13.01.2020 21:00;228;93;135;Leicht bewölkt;-1;-1;0
13.01.2020 22:00;213;89;124;Leicht bewölkt;-1;-1;0
13.01.2020 23:00;96;42;54;Sonnig;-1;-1;0
14.01.2020 00:00;39;16;23;Sonnig;-1;-1;0
14.01.2020 01:00;21;5;16;Sonnig;-1;-1;0
14.01.2020 02:00;4;2;2;Leicht bewölkt;-1;-1;0
14.01.2020 03:00;10;3;7;Leicht bewölkt;-1;-2;0
14.01.2020 04:00;7;6;1;Leicht bewölkt;-1;-1;0
14.01.2020 05:00;44;33;11;Bedeckt;-1;-1;0
14.01.2020 06:00;157;99;58;Bedeckt;-1;-1;0
14.01.2020 07:00;940;573;367;Bedeckt;0;0;0
14.01.2020 08:00;800;417;383;Leicht bewölkt;1;0;0
14.01.2020 09:00;684;431;253;Leicht bewölkt;1;1;0
14.01.2020 10:00;355;197;158;Leicht bewölkt;3;3;0
14.01.2020 11:00;489;257;232;Leicht bewölkt;5;4;0
14.01.2020 12:00;521;198;323;Leicht bewölkt;6;6;0
14.01.2020 13:00;756;359;397;Leicht bewölkt;6;6;0
14.01.2020 14:00;493;222;271;Leicht bewölkt;6;6;0
14.01.2020 15:00;790;351;439;Leicht bewölkt;5;5;0
14.01.2020 16:00;709;336;373;Leicht bewölkt;4;4;0
14.01.2020 17:00;928;436;492;Bedeckt;3;3;0
14.01.2020 18:00;698;287;411;Bedeckt;2;2;0
14.01.2020 19:00;630;265;365;Bedeckt;2;1;0
14.01.2020 20:00;334;135;199;Bewölkt;2;1;0
14.01.2020 21:00;256;102;154;Bewölkt;1;0;0
14.01.2020 22:00;181;60;121;Bewölkt;1;0;0
14.01.2020 23:00;109;51;58;Leicht bewölkt;1;0;0
15.01.2020 00:00;41;18;23;Leicht bewölkt;1;1;0
15.01.2020 01:00;27;6;21;Leicht bewölkt;1;0;0
15.01.2020 02:00;5;2;3;Leicht bewölkt;1;0;0
15.01.2020 03:00;7;6;1;Leicht bewölkt;0;0;0
15.01.2020 04:00;6;3;3;Leicht bewölkt;0;0;0
15.01.2020 05:00;50;32;18;Leicht bewölkt;0;0;0
15.01.2020 06:00;156;100;56;Leicht bewölkt;0;-1;0
15.01.2020 07:00;967;606;361;Leicht bewölkt;1;0;0
15.01.2020 08:00;693;401;292;Leicht bewölkt;1;1;0
15.01.2020 09:00;702;442;260;Leicht bewölkt;2;2;0
15.01.2020 10:00;350;181;169;Leicht bewölkt;4;3;0
15.01.2020 11:00;500;247;253;Sonnig;5;5;0
15.01.2020 12:00;574;251;323;Sonnig;7;6;0
15.01.2020 13:00;780;387;393;Sonnig;6;6;0
15.01.2020 14:00;542;254;288;Leicht bewölkt;6;5;0
15.01.2020 15:00;841;355;486;Leicht bewölkt;6;5;0
15.01.2020 16:00;729;356;373;Leicht bewölkt;5;4;0
15.01.2020 17:00;878;370;508;Leicht bewölkt;4;3;0
15.01.2020 18:00;716;287;429;Leicht bewölkt;3;2;0
15.01.2020 19:00;538;249;289;Leicht bewölkt;3;1;0
15.01.2020 20:00;402;163;239;Leicht bewölkt;2;1;0
15.01.2020 21:00;276;121;155;Leicht bewölkt;2;0;0
15.01.2020 22:00;240;104;136;Leicht bewölkt;2;0;0
15.01.2020 23:00;104;43;61;Leicht bewölkt;2;1;0
16.01.2020 00:00;69;23;46;Leicht bewölkt;3;1;0
16.01.2020 01:00;21;9;12;Leicht bewölkt;3;1;0
16.01.2020 02:00;6;2;4;Bewölkt;3;2;0
16.01.2020 03:00;10;5;5;Bewölkt;4;2;0
16.01.2020 04:00;8;6;2;Bewölkt;3;2;0
16.01.2020 05:00;46;32;14;Bewölkt;3;3;0
16.01.2020 06:00;164;104;60;Bewölkt;3;3;0
16.01.2020 07:00;946;578;368;Bewölkt;3;3;0
16.01.2020 08:00;704;415;289;Leicht bewölkt;4;4;0
16.01.2020 09:00;699;427;272;Leicht bewölkt;4;4;0
16.01.2020 10:00;377;210;167;Leicht bewölkt;6;5;0
16.01.2020 11:00;549;260;289;Leicht bewölkt;7;7;0
16.01.2020 12:00;530;227;303;Leicht bewölkt;8;8;0
16.01.2020 13:00;719;303;416;Leicht bewölkt;9;9;0
16.01.2020 14:00;565;234;331;Leicht bewölkt;9;9;0
16.01.2020 15:00;888;437;451;Leicht bewölkt;10;10;0
16.01.2020 16:00;731;327;404;Leicht bewölkt;9;9;0
16.01.2020 17:00;944;390;554;Leicht bewölkt;9;9;0
16.01.2020 18:00;765;356;409;Leicht bewölkt;8;8;0
16.01.2020 19:00;597;304;293;Leicht bewölkt;7;7;0
16.01.2020 20:00;366;141;225;Leicht bewölkt;6;6;0
16.01.2020 21:00;253;97;156;Leicht bewölkt;6;6;0
16.01.2020 22:00;265;103;162;Leicht bewölkt;5;5;0
16.01.2020 23:00;107;30;77;Sonnig;5;5;0
17.01.2020 00:00;63;21;42;Sonnig;5;5;0
17.01.2020 01:00;35;15;20;Sonnig;4;4;0
17.01.2020 02:00;19;10;9;Sonnig;4;4;0
17.01.2020 03:00;3;2;1;Sonnig;4;3;0
17.01.2020 04:00;4;3;1;Sonnig;3;2;0
17.01.2020 05:00;55;40;15;Leicht bewölkt;2;2;0
17.01.2020 06:00;159;90;69;Leicht bewölkt;2;1;0
17.01.2020 07:00;853;514;339;Leicht bewölkt;2;1;0
17.01.2020 08:00;642;373;269;Leicht bewölkt;3;2;0
17.01.2020 09:00;633;398;235;Leicht bewölkt;3;2;0
17.01.2020 10:00;379;193;186;Leicht bewölkt;5;4;0
17.01.2020 11:00;498;251;247;Leicht bewölkt;6;5;0
17.01.2020 12:00;659;316;343;Leicht bewölkt;7;7;0
17.01.2020 13:00;772;290;482;Leicht bewölkt;7;7;0
17.01.2020 14:00;629;300;329;Leicht bewölkt;7;7;0
17.01.2020 15:00;605;284;321;Leicht bewölkt;7;7;0
17.01.2020 16:00;611;267;344;Leicht bewölkt;7;6;0
17.01.2020 17:00;583;246;337;Leicht bewölkt;6;5;0
17.01.2020 18:00;525;236;289;Leicht bewölkt;5;4;0
17.01.2020 19:00;469;249;220;Leicht bewölkt;5;3;0
17.01.2020 20:00;273;121;152;Bedeckt;5;2;5
17.01.2020 21:00;227;93;134;Bedeckt;5;1;7
17.01.2020 22:00;162;61;101;Bedeckt;5;1;3
17.01.2020 23:00;153;54;99;Leichter Regenfall;4;1;7
18.01.2020 00:00;133;49;84;Leichter Regenfall;4;1;13
18.01.2020 01:00;100;34;66;Leichter Regenfall;4;1;7
18.01.2020 02:00;43;17;26;Leichter Regenfall;4;1;9
18.01.2020 03:00;28;6;22;Leichter Regenfall;4;2;12
18.01.2020 04:00;15;7;8;Leichter Regenfall;4;2;6
18.01.2020 05:00;23;12;11;Mäßiger Regenfall;4;1;1
18.01.2020 06:00;39;31;8;Mäßiger Regenfall;4;1;14
18.01.2020 07:00;66;30;36;Mäßiger Regenfall;4;1;7
18.01.2020 08:00;132;63;69;Mäßiger Regenfall;4;1;4
18.01.2020 09:00;257;161;96;Mäßiger Regenfall;4;1;5
18.01.2020 10:00;376;220;156;Mäßiger Regenfall;4;1;3
18.01.2020 11:00;424;227;197;Leichte Eisregen;5;2;1
18.01.2020 12:00;468;252;216;Leichte Eisregen;5;2;1
18.01.2020 13:00;449;234;215;Leichte Eisregen;5;2;1
18.01.2020 14:00;484;278;206;Stellenweiser Regenfall;5;2;1
18.01.2020 15:00;507;238;269;Stellenweiser Regenfall;5;3;1
18.01.2020 16:00;401;175;226;Stellenweiser Regenfall;4;2;0
18.01.2020 17:00;417;188;229;Stellenweiser Regenfall;3;1;0
18.01.2020 18:00;390;164;226;Stellenweiser Regenfall;2;1;0
18.01.2020 19:00;385;213;172;Stellenweiser Regenfall;2;1;0
18.01.2020 20:00;236;130;106;Leicht bewölkt;1;0;0
18.01.2020 21:00;171;79;92;Leicht bewölkt;1;0;0
18.01.2020 22:00;195;79;116;Leicht bewölkt;1;1;0
18.01.2020 23:00;161;55;106;Bedeckt;1;1;0
19.01.2020 00:00;141;49;92;Bedeckt;1;1;1
19.01.2020 01:00;109;47;62;Bedeckt;1;0;0
19.01.2020 02:00;70;17;53;Leichter Schneefall;0;-1;1
19.01.2020 03:00;37;8;29;Leichter Schneefall;0;-2;1
19.01.2020 04:00;19;11;8;Leichter Schneefall;0;-2;0
19.01.2020 05:00;16;9;7;Starker Schneefall;0;-2;1
19.01.2020 06:00;26;19;7;Starker Schneefall;0;-2;2
19.01.2020 07:00;34;19;15;Starker Schneefall;0;-1;1
19.01.2020 08:00;58;22;36;Stellenweise starker Schneefall;0;-1;1
19.01.2020 09:00;145;83;62;Stellenweise starker Schneefall;1;0;1
19.01.2020 10:00;184;100;84;Stellenweise starker Schneefall;1;0;0
19.01.2020 11:00;192;98;94;Leichte Schneeschauer;2;1;1
19.01.2020 12:00;212;105;107;Leichte Schneeschauer;3;1;1
19.01.2020 13:00;258;130;128;Leichte Schneeschauer;3;1;0
19.01.2020 14:00;269;120;149;Mäßige bis starke Schneefälle;3;0;2
19.01.2020 15:00;263;128;135;Mäßige bis starke Schneefälle;3;0;2
19.01.2020 16:00;273;125;148;Mäßige bis starke Schneefälle;2;-1;1
19.01.2020 17:00;278;135;143;Mäßige bis starke Schneefälle;1;-3;2
19.01.2020 18:00;222;122;100;Mäßige bis starke Schneefälle;0;-4;2
19.01.2020 19:00;162;79;83;Mäßige bis starke Schneefälle;0;-4;1
19.01.2020 20:00;184;88;96;Mäßige bis starke Schneefälle;-1;-5;0
19.01.2020 21:00;97;37;60;Mäßige bis starke Schneefälle;-1;-5;0
19.01.2020 22:00;100;47;53;Mäßige bis starke Schneefälle;-1;-5;0
19.01.2020 23:00;48;13;35;Leicht bewölkt;-1;-5;0
20.01.2020 00:00;36;9;27;Leicht bewölkt;-2;-5;0
20.01.2020 01:00;12;6;6;Leicht bewölkt;-2;-5;0
20.01.2020 02:00;5;2;3;Leicht bewölkt;-2;-5;0
20.01.2020 03:00;5;2;3;Leicht bewölkt;-2;-6;0
20.01.2020 04:00;5;2;3;Leicht bewölkt;-2;-6;0
20.01.2020 05:00;43;31;12;Leicht bewölkt;-2;-6;0
20.01.2020 06:00;154;97;57;Leicht bewölkt;-2;-6;0
20.01.2020 07:00;837;513;324;Leicht bewölkt;-2;-6;0
20.01.2020 08:00;659;356;303;Leicht bewölkt;-1;-5;0
20.01.2020 09:00;585;361;224;Leicht bewölkt;-1;-5;0
20.01.2020 10:00;278;141;137;Leicht bewölkt;0;-4;0
20.01.2020 11:00;442;233;209;Leicht bewölkt;1;-3;0
20.01.2020 12:00;366;168;198;Leicht bewölkt;2;-2;0
20.01.2020 13:00;690;323;367;Leicht bewölkt;2;-2;0
20.01.2020 14:00;443;208;235;Sonnig;2;-2;0
20.01.2020 15:00;759;355;404;Sonnig;2;-2;0
20.01.2020 16:00;623;267;356;Sonnig;1;-3;0
20.01.2020 17:00;800;380;420;Leicht bewölkt;1;-4;0
20.01.2020 18:00;657;316;341;Leicht bewölkt;0;-5;0
20.01.2020 19:00;516;227;289;Leicht bewölkt;-1;-5;0
20.01.2020 20:00;326;151;175;Sonnig;-1;-5;0
20.01.2020 21:00;213;82;131;Sonnig;-2;-5;0
20.01.2020 22:00;191;68;123;Sonnig;-1;-4;0
20.01.2020 23:00;87;34;53;Leicht bewölkt;-1;-3;0
21.01.2020 00:00;26;6;20;Leicht bewölkt;-1;-3;0
21.01.2020 01:00;15;3;12;Leicht bewölkt;-1;-3;0
21.01.2020 02:00;4;3;1;Sonnig;-1;-4;0
21.01.2020 03:00;6;1;5;Sonnig;-2;-4;0
21.01.2020 04:00;7;5;2;Sonnig;-2;-4;0
21.01.2020 05:00;45;30;15;Sonnig;-2;-4;0
21.01.2020 06:00;136;83;53;Sonnig;-2;-4;0
21.01.2020 07:00;900;571;329;Sonnig;-2;-4;0
21.01.2020 08:00;679;383;296;Sonnig;-1;-3;0
21.01.2020 09:00;635;379;256;Sonnig;0;-2;0
21.01.2020 10:00;337;201;136;Sonnig;1;-1;0
21.01.2020 11:00;484;229;255;Sonnig;2;1;0
21.01.2020 12:00;486;191;295;Sonnig;3;2;0
21.01.2020 13:00;724;316;408;Sonnig;3;2;0
21.01.2020 14:00;464;217;247;Leicht bewölkt;4;2;0
21.01.2020 15:00;777;380;397;Leicht bewölkt;4;3;0
21.01.2020 16:00;655;305;350;Leicht bewölkt;3;2;0
21.01.2020 17:00;836;362;474;Sonnig;2;0;0
21.01.2020 18:00;615;258;357;Sonnig;1;-1;0
21.01.2020 19:00;639;278;361;Sonnig;0;-2;0
21.01.2020 20:00;314;132;182;Sonnig;0;-2;0
21.01.2020 21:00;251;108;143;Sonnig;-1;-3;0
21.01.2020 22:00;232;77;155;Sonnig;-1;-3;0
21.01.2020 23:00;85;37;48;Leicht bewölkt;-2;-3;0
22.01.2020 00:00;28;9;19;Leicht bewölkt;-2;-3;0
22.01.2020 01:00;19;11;8;Leicht bewölkt;-2;-3;0
22.01.2020 02:00;9;3;6;Leicht bewölkt;-2;-3;0
22.01.2020 03:00;5;2;3;Leicht bewölkt;-2;-3;0
22.01.2020 04:00;7;5;2;Leicht bewölkt;-2;-3;0
22.01.2020 05:00;49;31;18;Leicht bewölkt;-2;-3;0
22.01.2020 06:00;153;95;58;Leicht bewölkt;-3;-3;0
22.01.2020 07:00;869;547;322;Leicht bewölkt;-2;-2;0
22.01.2020 08:00;671;383;288;Leicht bewölkt;-1;-1;0
22.01.2020 09:00;650;415;235;Leicht bewölkt;0;0;0
22.01.2020 10:00;330;185;145;Leicht bewölkt;2;2;0
22.01.2020 11:00;429;213;216;Sonnig;3;3;0
22.01.2020 12:00;481;184;297;Sonnig;5;5;0
22.01.2020 13:00;678;320;358;Sonnig;5;5;0
22.01.2020 14:00;459;215;244;Sonnig;5;5;0
22.01.2020 15:00;723;308;415;Sonnig;6;6;0
22.01.2020 16:00;642;298;344;Sonnig;5;4;0
22.01.2020 17:00;747;290;457;Sonnig;3;2;0
22.01.2020 18:00;628;267;361;Sonnig;2;1;0
22.01.2020 19:00;475;224;251;Sonnig;1;0;0
22.01.2020 20:00;364;158;206;Sonnig;1;0;0
22.01.2020 21:00;237;86;151;Sonnig;0;0;0
22.01.2020 22:00;232;94;138;Sonnig;0;-1;0
22.01.2020 23:00;113;38;75;Sonnig;0;-1;0
23.01.2020 00:00;44;18;26;Sonnig;0;-2;0
23.01.2020 01:00;12;7;5;Sonnig;-1;-3;0
23.01.2020 02:00;21;13;8;Sonnig;-1;-3;0
23.01.2020 03:00;4;2;2;Sonnig;-2;-4;0
23.01.2020 04:00;18;12;6;Sonnig;-2;-5;0
23.01.2020 05:00;51;37;14;Sonnig;-3;-5;0
23.01.2020 06:00;138;86;52;Sonnig;-3;-6;0
23.01.2020 07:00;900;549;351;Sonnig;-2;-5;0
23.01.2020 08:00;688;406;282;Sonnig;-2;-4;0
23.01.2020 09:00;624;405;219;Sonnig;-1;-3;0
23.01.2020 10:00;326;175;151;Sonnig;1;-2;0
23.01.2020 11:00;447;214;233;Sonnig;2;0;0
23.01.2020 12:00;467;208;259;Sonnig;3;2;0
23.01.2020 13:00;687;263;424;Sonnig;4;2;0
23.01.2020 14:00;422;198;224;Sonnig;4;3;0
23.01.2020 15:00;761;376;385;Sonnig;5;3;0
23.01.2020 16:00;698;324;374;Sonnig;4;3;0
23.01.2020 17:00;805;379;426;Sonnig;3;2;0
23.01.2020 18:00;667;270;397;Sonnig;2;2;0
23.01.2020 19:00;528;259;269;Sonnig;1;1;0
23.01.2020 20:00;335;165;170;Leicht bewölkt;0;0;0
23.01.2020 21:00;250;102;148;Leicht bewölkt;-1;-1;0
23.01.2020 22:00;235;91;144;Leicht bewölkt;-1;-1;0
23.01.2020 23:00;120;37;83;Leicht bewölkt;-1;-1;0
24.01.2020 00:00;60;21;39;Leicht bewölkt;-2;-2;0
24.01.2020 01:00;38;10;28;Leicht bewölkt;-1;-1;0
24.01.2020 02:00;12;7;5;Leicht bewölkt;-1;-1;0
24.01.2020 03:00;3;2;1;Leicht bewölkt;-1;-1;0
24.01.2020 04:00;4;2;2;Leicht bewölkt;0;0;0
24.01.2020 05:00;33;23;10;Sonnig;0;0;0
24.01.2020 06:00;145;89;56;Sonnig;0;0;0
24.01.2020 07:00;795;482;313;Sonnig;1;1;0
24.01.2020 08:00;622;390;232;Sonnig;2;2;0
24.01.2020 09:00;568;338;230;Sonnig;3;3;0
24.01.2020 10:00;386;213;173;Sonnig;4;4;0
24.01.2020 11:00;465;238;227;Sonnig;6;6;0
24.01.2020 12:00;574;264;310;Sonnig;7;7;0
24.01.2020 13:00;785;303;482;Sonnig;7;7;0
24.01.2020 14:00;507;243;264;Leicht bewölkt;6;6;0
24.01.2020 15:00;607;299;308;Leicht bewölkt;6;6;0
24.01.2020 16:00;598;264;334;Leicht bewölkt;5;5;0
24.01.2020 17:00;611;263;348;Leicht bewölkt;4;4;0
24.01.2020 18:00;545;263;282;Leicht bewölkt;3;3;0
24.01.2020 19:00;435;191;244;Leicht bewölkt;2;2;0
24.01.2020 20:00;276;122;154;Leicht bewölkt;1;1;0
24.01.2020 21:00;204;92;112;Leicht bewölkt;1;1;0
24.01.2020 22:00;160;58;102;Leicht bewölkt;0;0;0
24.01.2020 23:00;147;68;79;Leicht bewölkt;0;0;0
25.01.2020 00:00;122;33;89;Leicht bewölkt;0;0;0
25.01.2020 01:00;93;27;66;Leicht bewölkt;0;0;0
25.01.2020 02:00;57;32;25;Leicht bewölkt;-1;-1;0
25.01.2020 03:00;32;13;19;Leicht bewölkt;-1;-1;0
25.01.2020 04:00;13;6;7;Leicht bewölkt;-1;-1;0
25.01.2020 05:00;24;14;10;Leicht bewölkt;-1;-1;0
25.01.2020 06:00;27;13;14;Leicht bewölkt;-1;-1;0
25.01.2020 07:00;58;34;24;Leicht bewölkt;0;0;0
25.01.2020 08:00;146;76;70;Leicht bewölkt;1;1;0
25.01.2020 09:00;301;202;99;Leicht bewölkt;2;2;0
25.01.2020 10:00;324;199;125;Leicht bewölkt;3;3;0
25.01.2020 11:00;344;164;180;Leicht bewölkt;5;5;0
25.01.2020 12:00;418;214;204;Leicht bewölkt;6;6;0
25.01.2020 13:00;389;201;188;Leicht bewölkt;6;6;0
25.01.2020 14:00;395;201;194;Leicht bewölkt;6;6;0
25.01.2020 15:00;384;194;190;Leicht bewölkt;5;5;0
25.01.2020 16:00;375;190;185;Leicht bewölkt;4;4;0
25.01.2020 17:00;369;150;219;Leicht bewölkt;3;3;0
25.01.2020 18:00;349;144;205;Leicht bewölkt;2;2;0
25.01.2020 19:00;310;156;154;Leicht bewölkt;1;1;0
25.01.2020 20:00;241;116;125;Leicht bewölkt;1;1;0
25.01.2020 21:00;204;108;96;Leicht bewölkt;0;0;0
25.01.2020 22:00;159;69;90;Leicht bewölkt;0;0;0
25.01.2020 23:00;155;52;103;Leicht bewölkt;0;0;0
26.01.2020 00:00;121;45;76;Leicht bewölkt;0;0;0
26.01.2020 01:00;71;23;48;Leicht bewölkt;0;0;0
26.01.2020 02:00;55;19;36;Bewölkt;0;0;0
26.01.2020 03:00;40;10;30;Bewölkt;-1;-1;0
26.01.2020 04:00;22;2;20;Bewölkt;-1;-1;0
26.01.2020 05:00;25;8;17;Bedeckt;-1;-1;0
26.01.2020 06:00;29;18;11;Bedeckt;-1;-1;0
26.01.2020 07:00;32;15;17;Bedeckt;0;0;0
26.01.2020 08:00;67;35;32;Leicht bewölkt;1;1;0
26.01.2020 09:00;182;97;85;Leicht bewölkt;1;1;0
26.01.2020 10:00;156;84;72;Leicht bewölkt;3;3;0
26.01.2020 11:00;195;88;107;Leicht bewölkt;4;4;0
26.01.2020 12:00;184;92;92;Leicht bewölkt;5;5;0
26.01.2020 13:00;189;93;96;Leicht bewölkt;5;5;0
26.01.2020 14:00;233;107;126;Leicht bewölkt;6;6;0
26.01.2020 15:00;234;131;103;Leicht bewölkt;6;6;0
26.01.2020 16:00;226;109;117;Leicht bewölkt;5;5;0
26.01.2020 17:00;264;122;142;Leicht bewölkt;4;4;0
26.01.2020 18:00;248;119;129;Leicht bewölkt;3;3;0
26.01.2020 19:00;218;102;116;Leicht bewölkt;1;1;0
26.01.2020 20:00;135;54;81;Bewölkt;0;0;0
26.01.2020 21:00;91;41;50;Bewölkt;-1;-1;0
26.01.2020 22:00;91;31;60;Bewölkt;-1;-1;0
26.01.2020 23:00;48;25;23;Bedeckt;-1;-1;0
27.01.2020 00:00;22;7;15;Bedeckt;0;-1;0
27.01.2020 01:00;15;6;9;Bedeckt;0;0;0
27.01.2020 02:00;3;1;2;Leicht bewölkt;1;0;0
27.01.2020 03:00;5;2;3;Leicht bewölkt;2;0;0
27.01.2020 04:00;5;0;5;Leicht bewölkt;2;0;0
27.01.2020 05:00;39;25;14;Bedeckt;2;0;0
27.01.2020 06:00;153;100;53;Bedeckt;2;0;0
27.01.2020 07:00;841;510;331;Bedeckt;3;1;0
27.01.2020 08:00;641;355;286;Stellenweiser Nieselregen;4;2;0
27.01.2020 09:00;524;286;238;Stellenweiser Nieselregen;4;3;0
27.01.2020 10:00;392;227;165;Stellenweiser Nieselregen;6;5;0
27.01.2020 11:00;420;208;212;Leicht bewölkt;7;6;0
27.01.2020 12:00;508;206;302;Leicht bewölkt;8;8;0
27.01.2020 13:00;660;295;365;Leicht bewölkt;8;8;0
27.01.2020 14:00;478;252;226;Leicht bewölkt;8;8;0
27.01.2020 15:00;729;360;369;Leicht bewölkt;8;8;0
27.01.2020 16:00;652;287;365;Leicht bewölkt;7;7;0
27.01.2020 17:00;750;336;414;Leicht bewölkt;6;6;0
27.01.2020 18:00;625;295;330;Leicht bewölkt;5;5;0
27.01.2020 19:00;431;208;223;Leicht bewölkt;5;4;0
27.01.2020 20:00;337;146;191;Leicht bewölkt;4;3;0
27.01.2020 21:00;190;71;119;Leicht bewölkt;4;3;0
27.01.2020 22:00;148;56;92;Leicht bewölkt;4;2;0
27.01.2020 23:00;99;45;54;Bedeckt;4;2;0
28.01.2020 00:00;45;16;29;Bedeckt;4;2;0
28.01.2020 01:00;14;4;10;Bedeckt;4;2;0
28.01.2020 02:00;4;1;3;Bewölkt;4;1;7
28.01.2020 03:00;6;1;5;Bewölkt;4;1;1
28.01.2020 04:00;2;1;1;Bewölkt;4;1;5
28.01.2020 05:00;35;23;12;Mäßiger Regenfall;4;1;14
28.01.2020 06:00;141;77;64;Mäßiger Regenfall;3;1;19
28.01.2020 07:00;725;442;283;Mäßiger Regenfall;4;1;9
28.01.2020 08:00;480;289;191;Mäßiger Regenfall;4;1;17
28.01.2020 09:00;425;229;196;Mäßiger Regenfall;5;1;22
28.01.2020 10:00;209;130;79;Mäßiger Regenfall;5;1;11
28.01.2020 11:00;266;122;144;Mäßiger bis starker Regen mit Gewitter;5;0;23
28.01.2020 12:00;377;141;236;Mäßiger bis starker Regen mit Gewitter;5;0;3
28.01.2020 13:00;548;238;310;Mäßiger bis starker Regen mit Gewitter;4;-1;15
28.01.2020 14:00;392;193;199;Mäßiger bis starker Eisregen;4;-1;13
28.01.2020 15:00;470;223;247;Mäßiger bis starker Eisregen;3;-2;17
28.01.2020 16:00;509;261;248;Mäßiger bis starker Eisregen;3;-2;9
28.01.2020 17:00;530;251;279;Stellenweise starker Schneefall;3;-3;9
28.01.2020 18:00;432;179;253;Stellenweise starker Schneefall;2;-3;12
28.01.2020 19:00;347;142;205;Stellenweise starker Schneefall;2;-3;6
28.01.2020 20:00;196;73;123;Mäßiger bis starker Schneefall mit Gewitter;2;-3;5
28.01.2020 21:00;162;61;101;Mäßiger bis starker Schneefall mit Gewitter;2;-3;7
28.01.2020 22:00;144;55;89;Mäßiger bis starker Schneefall mit Gewitter;2;-3;3
28.01.2020 23:00;65;32;33;Mäßige bis starke Schneefälle;2;-3;5
29.01.2020 00:00;32;5;27;Mäßige bis starke Schneefälle;1;-4;1
29.01.2020 01:00;22;14;8;Mäßige bis starke Schneefälle;2;-3;5
29.01.2020 02:00;3;2;1;Starker Schneefall;2;-3;8
29.01.2020 03:00;4;1;3;Starker Schneefall;3;-2;11
29.01.2020 04:00;2;1;1;Starker Schneefall;3;-2;6
29.01.2020 05:00;41;27;14;Mäßiger bis starker Eisregen;2;-2;3
29.01.2020 06:00;134;87;47;Mäßiger bis starker Eisregen;2;-2;4
29.01.2020 07:00;716;407;309;Mäßiger bis starker Eisregen;2;-2;2
29.01.2020 08:00;571;336;235;Bedeckt;2;-2;1
29.01.2020 09:00;528;338;190;Bedeckt;3;-2;1
29.01.2020 10:00;356;194;162;Bedeckt;3;-1;1
29.01.2020 11:00;386;190;196;Mäßige bis starke Schneefälle;3;-1;3
29.01.2020 12:00;463;189;274;Mäßige bis starke Schneefälle;4;-1;4
29.01.2020 13:00;655;300;355;Mäßige bis starke Schneefälle;4;-1;2
29.01.2020 14:00;450;219;231;Leichter Eisregen;4;-1;3
29.01.2020 15:00;538;250;288;Leichter Eisregen;4;-1;4
29.01.2020 16:00;583;246;337;Leichter Eisregen;4;-1;2
29.01.2020 17:00;657;323;334;Leichte Eisregen;3;-1;1
29.01.2020 18:00;642;266;376;Leichte Eisregen;3;-1;1
29.01.2020 19:00;447;215;232;Leichte Eisregen;3;-1;1
29.01.2020 20:00;320;127;193;Bewölkt;3;-1;0
29.01.2020 21:00;215;99;116;Bewölkt;3;-1;0
29.01.2020 22:00;209;100;109;Bewölkt;3;-1;0
29.01.2020 23:00;89;38;51;Leichter Regenschauer;3;0;0
30.01.2020 00:00;62;21;41;Leichter Regenschauer;4;0;1
30.01.2020 01:00;15;5;10;Leichter Regenschauer;3;0;0
30.01.2020 02:00;11;7;4;Bedeckt;3;0;0
30.01.2020 03:00;8;2;6;Bedeckt;3;0;0
30.01.2020 04:00;9;4;5;Bedeckt;3;0;0
30.01.2020 05:00;53;35;18;Stellenweiser Regenfall;2;0;0
30.01.2020 06:00;142;79;63;Stellenweiser Regenfall;2;0;0
30.01.2020 07:00;785;463;322;Stellenweiser Regenfall;3;0;0
30.01.2020 08:00;669;406;263;Stellenweiser Regenfall;3;1;0
30.01.2020 09:00;645;385;260;Stellenweiser Regenfall;4;2;0
30.01.2020 10:00;361;200;161;Stellenweiser Regenfall;5;4;0
30.01.2020 11:00;467;232;235;Leicht bewölkt;6;5;0
30.01.2020 12:00;528;228;300;Leicht bewölkt;7;6;0
30.01.2020 13:00;710;296;414;Leicht bewölkt;7;7;0
30.01.2020 14:00;537;248;289;Leicht bewölkt;8;7;0
30.01.2020 15:00;719;358;361;Leicht bewölkt;8;7;0
30.01.2020 16:00;663;302;361;Leicht bewölkt;7;6;0
30.01.2020 17:00;803;370;433;Leicht bewölkt;6;5;0
30.01.2020 18:00;658;303;355;Leicht bewölkt;5;3;0
30.01.2020 19:00;429;218;211;Leicht bewölkt;4;3;0
30.01.2020 20:00;286;114;172;Nieselregen;3;2;5
30.01.2020 21:00;223;105;118;Nieselregen;2;1;7
30.01.2020 22:00;194;83;111;Nieselregen;3;2;3
30.01.2020 23:00;121;38;83;Leichter Regenfall;3;2;8
31.01.2020 00:00;53;14;39;Leichter Regenfall;4;2;16
31.01.2020 01:00;27;9;18;Leichter Regenfall;5;3;8
31.01.2020 02:00;7;0;7;Leichter Regenfall;6;4;4
31.01.2020 03:00;9;3;6;Leichter Regenfall;7;4;5
31.01.2020 04:00;5;2;3;Leichter Regenfall;7;5;2
31.01.2020 05:00;37;26;11;Nieselregen;7;5;0
31.01.2020 06:00;137;88;49;Nieselregen;8;6;0
31.01.2020 07:00;732;450;282;Nieselregen;8;6;0
31.01.2020 08:00;643;396;247;Bedeckt;9;7;0
31.01.2020 09:00;579;353;226;Bedeckt;9;7;0
31.01.2020 10:00;464;264;200;Bedeckt;10;8;0
31.01.2020 11:00;521;264;257;Bedeckt;10;9;0
31.01.2020 12:00;633;307;326;Bedeckt;11;10;0
31.01.2020 13:00;728;283;445;Bedeckt;11;10;0
31.01.2020 14:00;556;250;306;Leicht bewölkt;12;10;0
31.01.2020 15:00;603;300;303;Leicht bewölkt;12;11;0
31.01.2020 16:00;642;293;349;Leicht bewölkt;11;10;0
31.01.2020 17:00;650;281;369;Bedeckt;11;10;0
31.01.2020 18:00;609;286;323;Bedeckt;10;9;0
31.01.2020 19:00;427;201;226;Bedeckt;10;8;0
31.01.2020 20:00;304;143;161;Leicht bewölkt;9;8;0
31.01.2020 21:00;236;115;121;Leicht bewölkt;9;7;0
31.01.2020 22:00;177;82;95;Leicht bewölkt;8;7;0
31.01.2020 23:00;158;60;98;Leicht bewölkt;8;7;0
01.02.2020 00:00;132;36;96;Leicht bewölkt;8;7;0
01.02.2020 01:00;95;19;76;Leicht bewölkt;8;6;0
01.02.2020 02:00;52;14;38;Bewölkt;7;6;0
01.02.2020 03:00;45;16;29;Bewölkt;7;6;0
01.02.2020 04:00;13;2;11;Bewölkt;7;5;0
01.02.2020 05:00;31;19;12;Leicht bewölkt;6;5;0
01.02.2020 06:00;41;31;10;Leicht bewölkt;6;5;0
01.02.2020 07:00;84;56;28;Leicht bewölkt;6;5;0
01.02.2020 08:00;167;86;81;Leicht bewölkt;7;6;0
01.02.2020 09:00;356;202;154;Leicht bewölkt;8;7;0
01.02.2020 10:00;453;253;200;Leicht bewölkt;9;8;0
01.02.2020 11:00;480;270;210;Leicht bewölkt;10;9;0
01.02.2020 12:00;535;289;246;Leicht bewölkt;11;10;0
01.02.2020 13:00;517;235;282;Leicht bewölkt;11;10;0
01.02.2020 14:00;457;244;213;Leicht bewölkt;11;9;3
01.02.2020 15:00;404;201;203;Leicht bewölkt;11;9;4
01.02.2020 16:00;299;126;173;Leicht bewölkt;11;8;2
01.02.2020 17:00;334;137;197;Leichter Regenfall;10;8;3
01.02.2020 18:00;299;122;177;Leichter Regenfall;10;7;4
01.02.2020 19:00;276;136;140;Leichter Regenfall;10;7;2
01.02.2020 20:00;178;88;90;Nieselregen;9;7;4
01.02.2020 21:00;146;70;76;Nieselregen;9;6;5
01.02.2020 22:00;133;78;55;Nieselregen;9;6;2
01.02.2020 23:00;111;41;70;Leichter Regenfall;9;6;4
02.02.2020 00:00;101;27;74;Leichter Regenfall;9;6;7
02.02.2020 01:00;81;23;58;Leichter Regenfall;9;6;4
02.02.2020 02:00;38;8;30;Stellenweiser leichter Regenfall;9;6;3
02.02.2020 03:00;26;9;17;Stellenweiser leichter Regenfall;9;6;4
02.02.2020 04:00;12;3;9;Stellenweiser leichter Regenfall;8;6;2
02.02.2020 05:00;18;8;10;Leichter Regenschauer;8;6;2
02.02.2020 06:00;31;22;9;Leichter Regenschauer;8;6;3
02.02.2020 07:00;34;14;20;Leichter Regenschauer;8;6;1
02.02.2020 08:00;53;21;32;Leichter Regenschauer;8;6;3
02.02.2020 09:00;170;91;79;Leichter Regenschauer;8;6;4
02.02.2020 10:00;170;114;56;Leichter Regenschauer;8;6;2
02.02.2020 11:00;187;89;98;Stellenweiser leichter Regenfall;9;7;2
02.02.2020 12:00;177;76;101;Stellenweiser leichter Regenfall;9;7;2
02.02.2020 13:00;193;102;91;Stellenweiser leichter Regenfall;9;7;1
02.02.2020 14:00;212;116;96;Nieselregen;9;7;4
02.02.2020 15:00;203;116;87;Nieselregen;9;7;5
02.02.2020 16:00;204;98;106;Nieselregen;8;7;2
02.02.2020 17:00;226;89;137;Leichter Regenfall;8;6;2
02.02.2020 18:00;233;113;120;Leichter Regenfall;7;6;2
02.02.2020 19:00;182;100;82;Leichter Regenfall;6;5;1
02.02.2020 20:00;122;50;72;Bedeckt;5;4;5
02.02.2020 21:00;114;49;65;Bedeckt;4;4;7
02.02.2020 22:00;82;27;55;Bedeckt;5;5;4
02.02.2020 23:00;52;23;29;Leichter Regenfall;7;6;1
03.02.2020 00:00;21;8;13;Leichter Regenfall;9;7;21
03.02.2020 01:00;14;5;9;Leichter Regenfall;10;8;1
03.02.2020 02:00;9;5;4;Mäßiger Regenfall;11;8;8
03.02.2020 03:00;8;5;3;Mäßiger Regenfall;12;9;1
03.02.2020 04:00;22;16;6;Mäßiger Regenfall;12;9;5
03.02.2020 05:00;30;19;11;Leichter Regenfall;12;9;2
03.02.2020 06:00;144;92;52;Leichter Regenfall;12;9;3
03.02.2020 07:00;637;386;251;Leichter Regenfall;11;9;1
03.02.2020 08:00;481;286;195;Bedeckt;11;8;5
03.02.2020 09:00;381;226;155;Bedeckt;11;8;6
03.02.2020 10:00;226;127;99;Bedeckt;11;8;3
03.02.2020 11:00;277;119;158;Leichter Regenfall;11;8;2
03.02.2020 12:00;293;121;172;Leichter Regenfall;11;8;3
03.02.2020 13:00;427;181;246;Leichter Regenfall;11;8;2
03.02.2020 14:00;240;102;138;Bedeckt;11;8;12
03.02.2020 15:00;422;209;213;Bedeckt;11;9;16
03.02.2020 16:00;376;164;212;Bedeckt;10;8;8
03.02.2020 17:00;429;181;248;Mäßiger Regenfall;10;8;2
03.02.2020 18:00;390;194;196;Mäßiger Regenfall;9;8;26
03.02.2020 19:00;337;145;192;Mäßiger Regenfall;8;7;13
03.02.2020 20:00;225;99;126;Mäßiger Regenfall;7;6;7
03.02.2020 21:00;142;63;79;Mäßiger Regenfall;5;5;1
03.02.2020 22:00;129;68;61;Mäßiger Regenfall;6;6;5
03.02.2020 23:00;58;18;40;Stellenweiser Regenfall;7;6;0
04.02.2020 00:00;25;8;17;Stellenweiser Regenfall;7;6;0
04.02.2020 01:00;5;2;3;Stellenweiser Regenfall;8;6;0
04.02.2020 02:00;6;2;4;Bedeckt;9;7;0
04.02.2020 03:00;1;0;1;Bedeckt;10;8;0
04.02.2020 04:00;7;6;1;Bedeckt;9;6;0
04.02.2020 05:00;26;18;8;Leichter Regenschauer;8;4;0
04.02.2020 06:00;109;70;39;Leichter Regenschauer;7;3;0
04.02.2020 07:00;702;416;286;Leichter Regenschauer;6;2;0
04.02.2020 08:00;639;369;270;Bedeckt;5;1;3
04.02.2020 09:00;547;340;207;Bedeckt;4;0;4
04.02.2020 10:00;348;213;135;Bedeckt;4;0;2
04.02.2020 11:00;450;208;242;Leichte Eisregen;4;0;1
04.02.2020 12:00;441;184;257;Leichte Eisregen;4;0;2
04.02.2020 13:00;497;194;303;Leichte Eisregen;4;0;1
04.02.2020 14:00;405;174;231;Stellenweise Gewitter und Niederschläge;4;0;3
04.02.2020 15:00;603;300;303;Stellenweise Gewitter und Niederschläge;4;0;4
04.02.2020 16:00;604;300;304;Stellenweise Gewitter und Niederschläge;4;-1;2
04.02.2020 17:00;657;297;360;Leichte Eisregen;3;-1;4
04.02.2020 18:00;540;253;287;Leichte Eisregen;2;-2;5
04.02.2020 19:00;459;217;242;Leichte Eisregen;2;-2;3
04.02.2020 20:00;266;127;139;Mäßige bis starke Schneefälle;2;-2;2
04.02.2020 21:00;208;73;135;Mäßige bis starke Schneefälle;1;-3;3
04.02.2020 22:00;168;55;113;Mäßige bis starke Schneefälle;1;-2;1
04.02.2020 23:00;67;24;43;Mäßige bis starke Schneefälle;1;-2;2
05.02.2020 00:00;39;11;28;Mäßige bis starke Schneefälle;2;-2;5
05.02.2020 01:00;19;4;15;Mäßige bis starke Schneefälle;2;-2;2
05.02.2020 02:00;7;2;5;Starker Schneefall;2;-2;3
05.02.2020 03:00;1;0;1;Starker Schneefall;2;-2;4
05.02.2020 04:00;6;4;2;Starker Schneefall;2;-2;2
05.02.2020 05:00;57;39;18;Stellenweise starker Schneefall;2;-2;3
05.02.2020 06:00;150;93;57;Stellenweise starker Schneefall;2;-2;4
05.02.2020 07:00;718;417;301;Stellenweise starker Schneefall;2;-1;2
05.02.2020 08:00;627;355;272;Starker Schneefall;2;-1;2
05.02.2020 09:00;587;350;237;Starker Schneefall;2;-1;3
05.02.2020 10:00;369;205;164;Starker Schneefall;3;-1;1
05.02.2020 11:00;477;239;238;Mäßige bis starke Schneefälle;3;0;2
05.02.2020 12:00;475;213;262;Mäßige bis starke Schneefälle;3;0;3
05.02.2020 13:00;742;339;403;Mäßige bis starke Schneefälle;3;1;1
05.02.2020 14:00;526;260;266;Mäßige bis starke Schneefälle;4;2;1
05.02.2020 15:00;674;293;381;Mäßige bis starke Schneefälle;4;3;1
05.02.2020 16:00;683;324;359;Mäßige bis starke Schneefälle;3;2;1
05.02.2020 17:00;748;360;388;Mäßige bis starke Schneefälle;3;2;0
05.02.2020 18:00;632;279;353;Mäßige bis starke Schneefälle;2;2;0
05.02.2020 19:00;517;254;263;Mäßige bis starke Schneefälle;2;1;0
05.02.2020 20:00;396;166;230;Stellenweiser Schneefall;1;1;0
05.02.2020 21:00;265;113;152;Stellenweiser Schneefall;1;0;0
05.02.2020 22:00;234;109;125;Stellenweiser Schneefall;0;-1;0
05.02.2020 23:00;100;32;68;Leicht bewölkt;-1;-2;0
06.02.2020 00:00;62;25;37;Leicht bewölkt;-1;-3;0
06.02.2020 01:00;26;5;21;Leicht bewölkt;-1;-3;0
06.02.2020 02:00;11;3;8;Leicht bewölkt;-2;-3;0
06.02.2020 03:00;9;3;6;Leicht bewölkt;-2;-3;0
06.02.2020 04:00;6;3;3;Leicht bewölkt;-2;-3;0
06.02.2020 05:00;43;27;16;Leicht bewölkt;-2;-3;0
06.02.2020 06:00;130;80;50;Leicht bewölkt;-2;-2;0
06.02.2020 07:00;770;427;343;Leicht bewölkt;-1;-1;0
06.02.2020 08:00;626;334;292;Leicht bewölkt;0;-1;0
06.02.2020 09:00;545;316;229;Leicht bewölkt;1;0;0
06.02.2020 10:00;367;202;165;Leicht bewölkt;2;1;0
06.02.2020 11:00;410;206;204;Leicht bewölkt;4;3;0
06.02.2020 12:00;498;229;269;Leicht bewölkt;5;4;0
06.02.2020 13:00;642;262;380;Leicht bewölkt;6;5;0
06.02.2020 14:00;483;214;269;Leicht bewölkt;7;6;0
06.02.2020 15:00;688;333;355;Leicht bewölkt;8;8;0
06.02.2020 16:00;658;305;353;Leicht bewölkt;7;7;0
06.02.2020 17:00;827;392;435;Sonnig;7;7;0
06.02.2020 18:00;765;332;433;Sonnig;6;6;0
06.02.2020 19:00;488;234;254;Sonnig;5;5;0
06.02.2020 20:00;347;155;192;Sonnig;4;4;0
06.02.2020 21:00;238;108;130;Sonnig;2;2;0
06.02.2020 22:00;201;81;120;Sonnig;2;2;0
06.02.2020 23:00;106;46;60;Leicht bewölkt;1;1;0
07.02.2020 00:00;70;25;45;Leicht bewölkt;0;0;0
07.02.2020 01:00;27;5;22;Leicht bewölkt;0;0;0
07.02.2020 02:00;14;8;6;Leicht bewölkt;0;0;0
07.02.2020 03:00;7;3;4;Leicht bewölkt;0;0;0
07.02.2020 04:00;8;3;5;Leicht bewölkt;0;0;0
07.02.2020 05:00;37;27;10;Leicht bewölkt;0;0;0
07.02.2020 06:00;136;77;59;Leicht bewölkt;0;0;0
07.02.2020 07:00;691;392;299;Leicht bewölkt;1;1;0
07.02.2020 08:00;601;375;226;Leicht bewölkt;2;2;0
07.02.2020 09:00;572;333;239;Leicht bewölkt;3;3;0
07.02.2020 10:00;387;202;185;Leicht bewölkt;4;4;0
07.02.2020 11:00;498;239;259;Leicht bewölkt;6;5;0
07.02.2020 12:00;661;292;369;Leicht bewölkt;7;6;0
07.02.2020 13:00;806;326;480;Leicht bewölkt;7;7;0
07.02.2020 14:00;629;281;348;Sonnig;8;8;0
07.02.2020 15:00;611;275;336;Sonnig;9;8;0
07.02.2020 16:00;649;301;348;Sonnig;8;8;0
07.02.2020 17:00;640;292;348;Sonnig;7;7;0
07.02.2020 18:00;540;230;310;Sonnig;7;7;0
07.02.2020 19:00;394;181;213;Sonnig;6;6;0
07.02.2020 20:00;290;146;144;Sonnig;5;5;0
07.02.2020 21:00;178;90;88;Sonnig;3;3;0
07.02.2020 22:00;158;61;97;Sonnig;3;3;0
07.02.2020 23:00;156;62;94;Sonnig;3;3;0
08.02.2020 00:00;120;48;72;Sonnig;2;2;0
08.02.2020 01:00;64;19;45;Sonnig;2;2;0
08.02.2020 02:00;39;15;24;Sonnig;2;2;0
08.02.2020 03:00;21;7;14;Sonnig;2;2;0
08.02.2020 04:00;14;8;6;Sonnig;2;2;0
08.02.2020 05:00;17;7;10;Sonnig;1;1;0
08.02.2020 06:00;44;34;10;Sonnig;1;1;0
08.02.2020 07:00;56;33;23;Sonnig;2;2;0
08.02.2020 08:00;163;87;76;Sonnig;2;2;0
08.02.2020 09:00;278;184;94;Sonnig;3;3;0
08.02.2020 10:00;314;186;128;Sonnig;4;4;0
08.02.2020 11:00;369;180;189;Bedeckt;5;5;0
08.02.2020 12:00;365;204;161;Bedeckt;6;6;0
08.02.2020 13:00;387;188;199;Bedeckt;6;6;0
08.02.2020 14:00;401;186;215;Bewölkt;6;6;0
08.02.2020 15:00;397;218;179;Bewölkt;6;6;0
08.02.2020 16:00;378;148;230;Bewölkt;5;5;0
08.02.2020 17:00;439;183;256;Leicht bewölkt;4;4;0
08.02.2020 18:00;332;147;185;Leicht bewölkt;3;3;0
08.02.2020 19:00;339;195;144;Leicht bewölkt;3;2;0
08.02.2020 20:00;221;127;94;Leicht bewölkt;2;2;0
08.02.2020 21:00;209;82;127;Leicht bewölkt;2;1;0
08.02.2020 22:00;187;95;92;Leicht bewölkt;1;1;0
08.02.2020 23:00;154;47;107;Leicht bewölkt;1;0;0
09.02.2020 00:00;104;29;75;Leicht bewölkt;1;0;0
09.02.2020 01:00;105;27;78;Leicht bewölkt;1;0;0
09.02.2020 02:00;41;12;29;Leicht bewölkt;1;0;0
09.02.2020 03:00;37;12;25;Leicht bewölkt;1;0;0
09.02.2020 04:00;13;8;5;Leicht bewölkt;1;-1;0
09.02.2020 05:00;11;2;9;Leicht bewölkt;1;-1;0
09.02.2020 06:00;20;15;5;Leicht bewölkt;0;-1;0
09.02.2020 07:00;37;15;22;Leicht bewölkt;2;0;0
09.02.2020 08:00;47;21;26;Leicht bewölkt;3;2;0
09.02.2020 09:00;162;98;64;Leicht bewölkt;4;3;0
09.02.2020 10:00;156;101;55;Leicht bewölkt;6;5;0
09.02.2020 11:00;218;91;127;Leicht bewölkt;7;6;0
09.02.2020 12:00;285;126;159;Leicht bewölkt;9;8;0
09.02.2020 13:00;298;148;150;Leicht bewölkt;9;8;0
09.02.2020 14:00;362;186;176;Leicht bewölkt;9;8;0
09.02.2020 15:00;279;134;145;Leicht bewölkt;9;8;0
09.02.2020 16:00;307;144;163;Leicht bewölkt;8;7;0
09.02.2020 17:00;330;152;178;Leicht bewölkt;7;6;0
09.02.2020 18:00;243;114;129;Leicht bewölkt;6;6;0
09.02.2020 19:00;163;76;87;Leicht bewölkt;5;4;0
09.02.2020 20:00;142;62;80;Leicht bewölkt;5;3;0
09.02.2020 21:00;105;35;70;Leicht bewölkt;4;2;0
09.02.2020 22:00;89;40;49;Leicht bewölkt;4;2;0
09.02.2020 23:00;46;19;27;Leicht bewölkt;5;2;0
10.02.2020 00:00;25;13;12;Leicht bewölkt;5;2;0
10.02.2020 01:00;12;5;7;Leicht bewölkt;5;3;0
10.02.2020 02:00;7;4;3;Bewölkt;5;3;0
10.02.2020 03:00;6;3;3;Bewölkt;6;3;0
10.02.2020 04:00;5;1;4;Bewölkt;6;3;0
10.02.2020 05:00;23;14;9;Leicht bewölkt;7;4;0
10.02.2020 06:00;83;60;23;Leicht bewölkt;8;4;0
10.02.2020 07:00;319;169;150;Leicht bewölkt;8;4;0
10.02.2020 08:00;157;92;65;Leicht bewölkt;8;5;22
10.02.2020 09:00;180;92;88;Leicht bewölkt;9;5;29
10.02.2020 10:00;112;64;48;Leicht bewölkt;9;5;15
10.02.2020 11:00;147;76;71;Starker Regenfall;9;5;22
10.02.2020 12:00;221;113;108;Starker Regenfall;9;5;29
10.02.2020 13:00;251;123;128;Starker Regenfall;9;5;15
10.02.2020 14:00;222;121;101;Teilweise mäßiger Regenfall;8;4;6
10.02.2020 15:00;328;167;161;Teilweise mäßiger Regenfall;8;4;8
10.02.2020 16:00;388;202;186;Teilweise mäßiger Regenfall;8;4;4
10.02.2020 17:00;464;211;253;Stellenweiser Regenfall;7;3;0
10.02.2020 18:00;370;188;182;Stellenweiser Regenfall;6;3;0
10.02.2020 19:00;308;140;168;Stellenweiser Regenfall;5;3;0
10.02.2020 20:00;213;99;114;Leicht bewölkt;4;2;4
10.02.2020 21:00;133;70;63;Leicht bewölkt;3;2;6
10.02.2020 22:00;101;42;59;Leicht bewölkt;4;2;3
10.02.2020 23:00;56;19;37;Leichter Regenfall;5;2;2
11.02.2020 00:00;30;14;16;Leichter Regenfall;5;2;5
11.02.2020 01:00;9;1;8;Leichter Regenfall;5;1;2
11.02.2020 02:00;10;2;8;Bewölkt;5;1;12
11.02.2020 03:00;3;2;1;Bewölkt;5;0;16
11.02.2020 04:00;6;3;3;Bewölkt;4;-1;8
11.02.2020 05:00;27;17;10;Mäßiger Regenfall;4;-1;21
11.02.2020 06:00;123;71;52;Mäßiger Regenfall;3;-2;28
11.02.2020 07:00;595;327;268;Mäßiger Regenfall;4;-1;14
11.02.2020 08:00;564;326;238;Mäßiger Regenfall;4;-1;13
11.02.2020 09:00;404;244;160;Mäßiger Regenfall;5;0;17
11.02.2020 10:00;259;145;114;Mäßiger Regenfall;5;0;8
11.02.2020 11:00;325;139;186;Stellenweiser leichter Regenfall;5;0;6
11.02.2020 12:00;374;143;231;Stellenweiser leichter Regenfall;5;0;8
11.02.2020 13:00;466;219;247;Stellenweiser leichter Regenfall;5;0;4
11.02.2020 14:00;324;138;186;Leichter Regenfall;5;0;8
11.02.2020 15:00;452;209;243;Leichter Regenfall;5;-1;11
11.02.2020 16:00;430;190;240;Leichter Regenfall;4;-1;5
11.02.2020 17:00;523;272;251;Mäßiger Regenfall;4;-1;11
11.02.2020 18:00;516;241;275;Mäßiger Regenfall;4;-1;15
11.02.2020 19:00;373;172;201;Mäßiger Regenfall;3;-2;7
11.02.2020 20:00;220;103;117;Mäßiger bis starker Eisregen;3;-2;5
11.02.2020 21:00;207;86;121;Mäßiger bis starker Eisregen;3;-2;7
11.02.2020 22:00;130;41;89;Mäßiger bis starker Eisregen;3;-3;3
11.02.2020 23:00;61;29;32;Starker Schneefall;3;-3;1
12.02.2020 00:00;38;18;20;Starker Schneefall;2;-3;1
12.02.2020 01:00;28;6;22;Starker Schneefall;2;-3;1
12.02.2020 02:00;4;3;1;Bewölkt;2;-3;2
12.02.2020 03:00;9;2;7;Bewölkt;2;-3;2
12.02.2020 04:00;3;0;3;Bewölkt;2;-3;1
12.02.2020 05:00;50;38;12;Stellenweise starker Schneefall;2;-3;4
12.02.2020 06:00;133;80;53;Stellenweise starker Schneefall;2;-3;6
12.02.2020 07:00;783;456;327;Stellenweise starker Schneefall;2;-2;3
12.02.2020 08:00;608;343;265;Mäßige bis starke Schneefälle;2;-2;3
12.02.2020 09:00;491;289;202;Mäßige bis starke Schneefälle;3;-2;4
12.02.2020 10:00;375;191;184;Mäßige bis starke Schneefälle;3;-1;2
12.02.2020 11:00;397;190;207;Starker Schneefall;4;-1;0
12.02.2020 12:00;530;198;332;Starker Schneefall;5;0;0
12.02.2020 13:00;559;268;291;Starker Schneefall;5;0;0
12.02.2020 14:00;519;265;254;Leicht bewölkt;5;1;1
12.02.2020 15:00;566;275;291;Leicht bewölkt;5;1;1
12.02.2020 16:00;644;303;341;Leicht bewölkt;5;1;1
12.02.2020 17:00;721;329;392;Leichter Regenschauer;4;0;0
12.02.2020 18:00;567;250;317;Leichter Regenschauer;4;0;0
12.02.2020 19:00;435;187;248;Leichter Regenschauer;3;0;0
12.02.2020 20:00;328;161;167;Leicht bewölkt;3;0;0
12.02.2020 21:00;234;105;129;Leicht bewölkt;2;0;0
12.02.2020 22:00;198;102;96;Leicht bewölkt;2;-1;0
12.02.2020 23:00;94;29;65;Stellenweiser Regenfall;2;-1;0
13.02.2020 00:00;53;13;40;Stellenweiser Regenfall;1;-1;0
13.02.2020 01:00;26;2;24;Stellenweiser Regenfall;1;-1;0
13.02.2020 02:00;14;11;3;Leicht bewölkt;1;-1;0
13.02.2020 03:00;9;4;5;Leicht bewölkt;1;-2;0
13.02.2020 04:00;3;3;0;Leicht bewölkt;1;-2;0
13.02.2020 05:00;50;35;15;Leicht bewölkt;0;-2;0
13.02.2020 06:00;128;69;59;Leicht bewölkt;0;-2;0
13.02.2020 07:00;790;444;346;Leicht bewölkt;1;-1;0
13.02.2020 08:00;553;331;222;Leicht bewölkt;2;0;0
13.02.2020 09:00;579;342;237;Leicht bewölkt;2;1;0
13.02.2020 10:00;367;217;150;Leicht bewölkt;3;2;0
13.02.2020 11:00;393;181;212;Leicht bewölkt;4;3;0
13.02.2020 12:00;498;212;286;Leicht bewölkt;6;4;0
13.02.2020 13:00;631;259;372;Leicht bewölkt;6;5;0
13.02.2020 14:00;506;252;254;Bedeckt;6;5;0
13.02.2020 15:00;693;384;309;Bedeckt;6;6;0
13.02.2020 16:00;614;285;329;Bedeckt;6;5;0
13.02.2020 17:00;696;315;381;Stellenweiser Regenfall;5;4;0
13.02.2020 18:00;539;244;295;Stellenweiser Regenfall;5;3;0
13.02.2020 19:00;353;143;210;Stellenweiser Regenfall;4;1;0
13.02.2020 20:00;267;106;161;Bedeckt;4;0;13
13.02.2020 21:00;175;80;95;Bedeckt;3;-1;17
13.02.2020 22:00;147;49;98;Bedeckt;3;-1;9
13.02.2020 23:00;78;24;54;Mäßiger Regenfall;3;-1;23
14.02.2020 00:00;42;15;27;Mäßiger Regenfall;3;-1;46
14.02.2020 01:00;24;10;14;Mäßiger Regenfall;4;-1;23
14.02.2020 02:00;15;8;7;Mäßiger Regenfall;4;0;11
14.02.2020 03:00;7;5;2;Mäßiger Regenfall;5;1;15
14.02.2020 04:00;7;4;3;Mäßiger Regenfall;5;1;7
14.02.2020 05:00;42;34;8;Leichter Regenschauer;5;1;1
14.02.2020 06:00;122;72;50;Leichter Regenschauer;4;1;2
14.02.2020 07:00;721;411;310;Leichter Regenschauer;5;1;1
14.02.2020 08:00;555;333;222;Leicht bewölkt;5;1;0
14.02.2020 09:00;545;331;214;Leicht bewölkt;6;2;0
14.02.2020 10:00;407;211;196;Leicht bewölkt;6;3;0
14.02.2020 11:00;578;338;240;Leichter Regenschauer;7;3;0
14.02.2020 12:00;642;304;338;Leichter Regenschauer;7;4;0
14.02.2020 13:00;738;256;482;Leichter Regenschauer;8;5;0
14.02.2020 14:00;592;241;351;Bedeckt;8;5;1
14.02.2020 15:00;568;265;303;Bedeckt;8;6;1
14.02.2020 16:00;604;314;290;Bedeckt;7;5;0
14.02.2020 17:00;564;294;270;Stellenweiser Regenfall;6;4;0
14.02.2020 18:00;586;277;309;Stellenweiser Regenfall;6;4;0
14.02.2020 19:00;454;208;246;Stellenweiser Regenfall;5;3;0
14.02.2020 20:00;279;142;137;Leicht bewölkt;4;2;0
14.02.2020 21:00;229;119;110;Leicht bewölkt;3;1;0
14.02.2020 22:00;191;72;119;Leicht bewölkt;2;1;0
14.02.2020 23:00;163;47;116;Leicht bewölkt;2;0;0
15.02.2020 00:00;121;32;89;Leicht bewölkt;1;-1;0
15.02.2020 01:00;91;31;60;Leicht bewölkt;1;-1;0
15.02.2020 02:00;69;30;39;Bedeckt;1;0;0
15.02.2020 03:00;36;9;27;Bedeckt;1;0;0
15.02.2020 04:00;22;10;12;Bedeckt;1;0;0
15.02.2020 05:00;23;9;14;Bedeckt;1;0;0
15.02.2020 06:00;42;24;18;Bedeckt;1;0;0
15.02.2020 07:00;62;35;27;Bedeckt;2;1;0
15.02.2020 08:00;153;75;78;Leicht bewölkt;2;2;0
15.02.2020 09:00;247;144;103;Leicht bewölkt;3;3;0
15.02.2020 10:00;361;175;186;Leicht bewölkt;5;4;0
15.02.2020 11:00;414;248;166;Bedeckt;6;6;0
15.02.2020 12:00;576;318;258;Bedeckt;8;7;0
15.02.2020 13:00;503;255;248;Bedeckt;8;8;0
15.02.2020 14:00;481;247;234;Leicht bewölkt;9;9;0
15.02.2020 15:00;505;268;237;Leicht bewölkt;10;10;0
15.02.2020 16:00;473;238;235;Leicht bewölkt;9;9;0
15.02.2020 17:00;430;168;262;Leicht bewölkt;9;9;0
15.02.2020 18:00;401;177;224;Leicht bewölkt;8;8;0
15.02.2020 19:00;319;169;150;Leicht bewölkt;7;7;0
15.02.2020 20:00;234;114;120;Sonnig;6;5;0
15.02.2020 21:00;229;102;127;Sonnig;4;4;0
15.02.2020 22:00;197;93;104;Sonnig;4;3;0
15.02.2020 23:00;190;67;123;Leicht bewölkt;4;2;0
16.02.2020 00:00;118;43;75;Leicht bewölkt;3;2;0
16.02.2020 01:00;117;39;78;Leicht bewölkt;3;2;0
16.02.2020 02:00;76;18;58;Leicht bewölkt;3;2;0
16.02.2020 03:00;59;17;42;Leicht bewölkt;3;2;0
16.02.2020 04:00;15;4;11;Leicht bewölkt;3;2;0
16.02.2020 05:00;14;8;6;Leicht bewölkt;3;2;0
16.02.2020 06:00;23;15;8;Leicht bewölkt;4;2;0
16.02.2020 07:00;23;13;10;Leicht bewölkt;4;3;0
16.02.2020 08:00;66;25;41;Leicht bewölkt;5;4;0
16.02.2020 09:00;156;79;77;Leicht bewölkt;6;5;0
16.02.2020 10:00;178;94;84;Leicht bewölkt;8;7;0
16.02.2020 11:00;208;106;102;Leicht bewölkt;9;9;0
16.02.2020 12:00;200;99;101;Leicht bewölkt;11;11;0
16.02.2020 13:00;247;128;119;Leicht bewölkt;11;11;0
16.02.2020 14:00;326;179;147;Leicht bewölkt;11;11;0
16.02.2020 15:00;330;183;147;Leicht bewölkt;12;12;0
16.02.2020 16:00;305;130;175;Leicht bewölkt;11;10;0
16.02.2020 17:00;331;145;186;Leicht bewölkt;10;9;0
16.02.2020 18:00;281;142;139;Leicht bewölkt;9;8;0
16.02.2020 19:00;197;110;87;Leicht bewölkt;8;7;0
16.02.2020 20:00;140;66;74;Leicht bewölkt;7;6;0
16.02.2020 21:00;139;49;90;Leicht bewölkt;7;5;0
16.02.2020 22:00;97;47;50;Leicht bewölkt;6;5;0
16.02.2020 23:00;57;27;30;Leicht bewölkt;6;4;0
17.02.2020 00:00;33;13;20;Leicht bewölkt;6;4;0
17.02.2020 01:00;9;3;6;Leicht bewölkt;6;4;0
17.02.2020 02:00;3;3;0;Leicht bewölkt;6;4;0
17.02.2020 03:00;5;3;2;Leicht bewölkt;7;4;0
17.02.2020 04:00;2;2;0;Leicht bewölkt;7;5;0
17.02.2020 05:00;51;35;16;Leicht bewölkt;7;6;0
17.02.2020 06:00;148;93;55;Leicht bewölkt;8;6;0
17.02.2020 07:00;752;444;308;Leicht bewölkt;8;7;0
17.02.2020 08:00;652;388;264;Leicht bewölkt;9;8;0
17.02.2020 09:00;520;293;227;Leicht bewölkt;10;9;0
17.02.2020 10:00;370;192;178;Leicht bewölkt;11;10;0
17.02.2020 11:00;397;171;226;Leicht bewölkt;12;11;0
17.02.2020 12:00;458;210;248;Leicht bewölkt;13;12;0
17.02.2020 13:00;625;258;367;Leicht bewölkt;12;11;0
17.02.2020 14:00;370;173;197;Bedeckt;11;10;2
17.02.2020 15:00;578;281;297;Bedeckt;10;10;2
17.02.2020 16:00;500;233;267;Bedeckt;10;8;1
17.02.2020 17:00;534;241;293;Leichter Regenfall;9;7;7
17.02.2020 18:00;539;239;300;Leichter Regenfall;8;6;1
17.02.2020 19:00;340;159;181;Leichter Regenfall;8;5;5
17.02.2020 20:00;251;118;133;Mäßiger Regenfall;7;4;12
17.02.2020 21:00;170;80;90;Mäßiger Regenfall;7;4;16
17.02.2020 22:00;126;44;82;Mäßiger Regenfall;7;3;8
17.02.2020 23:00;54;21;33;Mäßiger Regenfall;6;3;17
18.02.2020 00:00;41;13;28;Mäßiger Regenfall;6;3;33
18.02.2020 01:00;15;11;4;Mäßiger Regenfall;5;2;17
18.02.2020 02:00;8;3;5;Mäßiger Regenfall;5;1;7
18.02.2020 03:00;4;3;1;Mäßiger Regenfall;4;1;1
18.02.2020 04:00;8;5;3;Mäßiger Regenfall;4;1;5
18.02.2020 05:00;51;35;16;Stellenweiser Regenfall;4;0;1
18.02.2020 06:00;148;97;51;Stellenweiser Regenfall;3;0;2
18.02.2020 07:00;762;419;343;Stellenweiser Regenfall;4;0;1
18.02.2020 08:00;617;325;292;Stellenweiser Regenfall;4;1;0
18.02.2020 09:00;534;322;212;Stellenweiser Regenfall;5;1;0
18.02.2020 10:00;402;213;189;Stellenweiser Regenfall;5;2;0
18.02.2020 11:00;438;194;244;Leicht bewölkt;6;3;0
18.02.2020 12:00;513;201;312;Leicht bewölkt;7;3;0
18.02.2020 13:00;654;295;359;Leicht bewölkt;7;4;0
18.02.2020 14:00;494;256;238;Leicht bewölkt;7;4;0
18.02.2020 15:00;730;344;386;Leicht bewölkt;7;4;0
18.02.2020 16:00;678;353;325;Leicht bewölkt;6;4;0
18.02.2020 17:00;779;352;427;Leicht bewölkt;5;3;0
18.02.2020 18:00;709;346;363;Leicht bewölkt;4;2;0
18.02.2020 19:00;541;247;294;Leicht bewölkt;4;1;0
18.02.2020 20:00;311;144;167;Leicht bewölkt;3;0;0
18.02.2020 21:00;227;94;133;Leicht bewölkt;2;0;0
18.02.2020 22:00;192;68;124;Leicht bewölkt;2;0;0
18.02.2020 23:00;129;36;93;Bewölkt;2;0;0
19.02.2020 00:00;52;24;28;Bewölkt;2;0;0
19.02.2020 01:00;12;2;10;Bewölkt;2;0;0
19.02.2020 02:00;11;2;9;Leicht bewölkt;3;0;0
19.02.2020 03:00;2;2;0;Leicht bewölkt;3;0;0
19.02.2020 04:00;9;6;3;Leicht bewölkt;3;0;0
19.02.2020 05:00;54;38;16;Bedeckt;3;0;0
19.02.2020 06:00;142;85;57;Bedeckt;4;0;0
19.02.2020 07:00;727;418;309;Bedeckt;4;0;0
19.02.2020 08:00;538;298;240;Bewölkt;4;0;1
19.02.2020 09:00;331;193;138;Bewölkt;4;-1;1
19.02.2020 10:00;194;111;83;Bewölkt;4;-1;1
19.02.2020 11:00;294;148;146;Leichter Eisregen;4;-1;1
19.02.2020 12:00;388;151;237;Leichter Eisregen;4;-1;1
19.02.2020 13:00;618;289;329;Leichter Eisregen;4;0;0
19.02.2020 14:00;437;216;221;Bewölkt;5;0;2
19.02.2020 15:00;583;254;329;Bewölkt;5;1;3
19.02.2020 16:00;649;296;353;Bewölkt;4;0;2
19.02.2020 17:00;624;270;354;Leichter Regenschauer;4;0;2
19.02.2020 18:00;624;277;347;Leichter Regenschauer;3;0;3
19.02.2020 19:00;543;333;210;Leichter Regenschauer;3;0;2
19.02.2020 20:00;288;136;152;Stellenweiser Eisregen;2;-1;1
19.02.2020 21:00;360;102;258;Stellenweiser Eisregen;1;-1;1
19.02.2020 22:00;155;73;82;Stellenweiser Eisregen;1;-1;0
19.02.2020 23:00;116;46;70;Bedeckt;1;-1;0
20.02.2020 00:00;57;18;39;Bedeckt;1;-1;1
20.02.2020 01:00;32;8;24;Bedeckt;1;-1;0
20.02.2020 02:00;15;3;12;Leichter Nebel;1;-1;0
20.02.2020 03:00;3;1;2;Leichter Nebel;2;-1;0
20.02.2020 04:00;6;3;3;Leichter Nebel;2;-1;0
20.02.2020 05:00;55;36;19;Leicht bewölkt;2;0;0
20.02.2020 06:00;130;84;46;Leicht bewölkt;2;0;0
20.02.2020 07:00;424;241;183;Leicht bewölkt;3;1;0
20.02.2020 08:00;467;224;243;Leicht bewölkt;4;2;0
20.02.2020 09:00;372;161;211;Leicht bewölkt;4;3;0
20.02.2020 10:00;372;200;172;Leicht bewölkt;6;4;0
20.02.2020 11:00;299;184;115;Leicht bewölkt;7;6;0
20.02.2020 12:00;371;251;120;Leicht bewölkt;8;7;0
20.02.2020 13:00;352;181;171;Leicht bewölkt;8;8;0
20.02.2020 14:00;371;196;175;Leicht bewölkt;9;9;0
20.02.2020 15:00;359;196;163;Leicht bewölkt;9;9;0
20.02.2020 16:00;355;164;191;Leicht bewölkt;9;9;0
20.02.2020 17:00;405;208;197;Leicht bewölkt;8;8;0
20.02.2020 18:00;451;286;165;Leicht bewölkt;8;8;0
20.02.2020 19:00;266;153;113;Leicht bewölkt;6;6;0
20.02.2020 20:00;254;89;165;Leicht bewölkt;5;4;0
20.02.2020 21:00;185;55;130;Leicht bewölkt;4;3;0
20.02.2020 22:00;174;41;133;Leicht bewölkt;5;2;0
20.02.2020 23:00;145;25;120;Leicht bewölkt;5;2;0
21.02.2020 00:00;122;20;102;Leicht bewölkt;5;2;0
21.02.2020 01:00;72;8;64;Leicht bewölkt;5;2;0
21.02.2020 02:00;41;5;36;Bedeckt;5;2;2
21.02.2020 03:00;36;3;33;Bedeckt;5;2;3
21.02.2020 04:00;22;9;13;Bedeckt;5;2;2
21.02.2020 05:00;30;21;9;Stellenweiser leichter Regenfall;4;1;1
21.02.2020 06:00;81;53;28;Stellenweiser leichter Regenfall;3;1;1
21.02.2020 07:00;203;119;84;Stellenweiser leichter Regenfall;3;2;1
21.02.2020 08:00;273;162;111;Leicht bewölkt;4;2;0
21.02.2020 09:00;307;173;134;Leicht bewölkt;4;3;0
21.02.2020 10:00;329;193;136;Leicht bewölkt;5;3;0
21.02.2020 11:00;393;188;205;Leicht bewölkt;6;4;0
21.02.2020 12:00;407;161;246;Leicht bewölkt;7;5;0
21.02.2020 13:00;407;190;217;Leicht bewölkt;7;5;0
21.02.2020 14:00;437;236;201;Leicht bewölkt;7;5;0
21.02.2020 15:00;425;189;236;Leicht bewölkt;7;6;0
21.02.2020 16:00;447;186;261;Leicht bewölkt;7;5;0
21.02.2020 17:00;516;217;299;Bedeckt;6;5;0
21.02.2020 18:00;446;212;234;Bedeckt;6;5;0
21.02.2020 19:00;307;147;160;Bedeckt;5;4;0
21.02.2020 20:00;206;116;90;Bewölkt;4;4;0
21.02.2020 21:00;146;63;83;Bewölkt;4;3;0
21.02.2020 22:00;140;68;72;Bewölkt;3;3;0
21.02.2020 23:00;85;29;56;Bewölkt;3;3;0
22.02.2020 00:00;62;19;43;Bewölkt;3;2;0
22.02.2020 01:00;42;9;33;Bewölkt;2;2;0
22.02.2020 02:00;20;7;13;Leicht bewölkt;2;1;0
22.02.2020 03:00;10;5;5;Leicht bewölkt;1;1;0
22.02.2020 04:00;6;3;3;Leicht bewölkt;1;1;0
22.02.2020 05:00;23;16;7;Leicht bewölkt;1;1;0
22.02.2020 06:00;28;16;12;Leicht bewölkt;1;1;0
22.02.2020 07:00;58;33;25;Leicht bewölkt;2;2;0
22.02.2020 08:00;104;53;51;Leicht bewölkt;3;3;0
22.02.2020 09:00;224;126;98;Leicht bewölkt;5;4;0
22.02.2020 10:00;357;191;166;Leicht bewölkt;7;6;0
22.02.2020 11:00;378;195;183;Leicht bewölkt;8;7;0
22.02.2020 12:00;385;205;180;Leicht bewölkt;10;9;0
22.02.2020 13:00;409;203;206;Leicht bewölkt;11;10;0
22.02.2020 14:00;455;217;238;Leicht bewölkt;11;10;0
22.02.2020 15:00;440;218;222;Leicht bewölkt;12;11;0
22.02.2020 16:00;392;182;210;Leicht bewölkt;11;10;0
22.02.2020 17:00;361;175;186;Leicht bewölkt;10;8;0
22.02.2020 18:00;310;148;162;Leicht bewölkt;9;7;0
22.02.2020 19:00;265;174;91;Leicht bewölkt;8;6;0
22.02.2020 20:00;206;128;78;Leicht bewölkt;7;6;0
22.02.2020 21:00;112;68;44;Leicht bewölkt;7;5;0
22.02.2020 22:00;119;47;72;Leicht bewölkt;7;5;0
22.02.2020 23:00;121;37;84;Bewölkt;7;5;0
23.02.2020 00:00;91;20;71;Bewölkt;7;5;0
23.02.2020 01:00;92;14;78;Bewölkt;7;5;0
23.02.2020 02:00;66;7;59;Bewölkt;7;5;0
23.02.2020 03:00;43;6;37;Bewölkt;8;6;0
23.02.2020 04:00;40;5;35;Bewölkt;8;6;0
23.02.2020 05:00;9;5;4;Bedeckt;8;6;0
23.02.2020 06:00;18;9;9;Bedeckt;8;6;0
23.02.2020 07:00;30;15;15;Bedeckt;8;6;0
23.02.2020 08:00;48;24;24;Bewölkt;8;6;0
23.02.2020 09:00;103;60;43;Bewölkt;9;6;0
23.02.2020 10:00;146;88;58;Bewölkt;9;7;0
23.02.2020 11:00;187;111;76;Stellenweiser Regenfall;9;7;0
23.02.2020 12:00;432;353;79;Stellenweiser Regenfall;10;7;0
23.02.2020 13:00;295;208;87;Stellenweiser Regenfall;10;8;0
23.02.2020 14:00;270;141;129;Bedeckt;10;8;1
23.02.2020 15:00;297;110;187;Bedeckt;11;9;1
23.02.2020 16:00;413;69;344;Bedeckt;11;9;0
23.02.2020 17:00;238;79;159;Nieselregen;10;9;1
23.02.2020 18:00;222;96;126;Nieselregen;10;9;1
23.02.2020 19:00;157;80;77;Nieselregen;8;8;0
23.02.2020 20:00;121;63;58;Stellenweiser Regenfall;7;7;0
23.02.2020 21:00;75;25;50;Stellenweiser Regenfall;5;5;0
23.02.2020 22:00;82;20;62;Stellenweiser Regenfall;6;6;0
23.02.2020 23:00;56;21;35;Bedeckt;7;6;0
24.02.2020 00:00;47;25;22;Bedeckt;8;6;0
24.02.2020 01:00;18;9;9;Bedeckt;9;7;0
24.02.2020 02:00;14;6;8;Bedeckt;9;7;1
24.02.2020 03:00;4;2;2;Bedeckt;10;8;1
24.02.2020 04:00;2;2;0;Bedeckt;10;8;1
24.02.2020 05:00;37;25;12;Nieselregen;10;8;1
24.02.2020 06:00;117;81;36;Nieselregen;10;8;2
24.02.2020 07:00;250;146;104;Nieselregen;10;8;1
24.02.2020 08:00;314;165;149;Nieselregen;10;8;1
24.02.2020 09:00;270;130;140;Nieselregen;10;8;2
24.02.2020 10:00;292;158;134;Nieselregen;11;9;1
24.02.2020 11:00;292;151;141;Stellenweiser Nieselregen;11;10;0
24.02.2020 12:00;336;164;172;Stellenweiser Nieselregen;12;12;0
24.02.2020 13:00;358;195;163;Stellenweiser Nieselregen;13;12;0
24.02.2020 14:00;403;194;209;Leicht bewölkt;13;12;0
24.02.2020 15:00;382;162;220;Leicht bewölkt;14;13;0
24.02.2020 16:00;446;224;222;Leicht bewölkt;13;12;0
24.02.2020 17:00;494;239;255;Leicht bewölkt;12;10;0
24.02.2020 18:00;466;234;232;Leicht bewölkt;11;9;0
24.02.2020 19:00;342;195;147;Leicht bewölkt;10;8;0
24.02.2020 20:00;215;125;90;Sonnig;9;7;0
24.02.2020 21:00;168;71;97;Sonnig;8;6;0
24.02.2020 22:00;116;53;63;Sonnig;8;6;0
24.02.2020 23:00;84;26;58;Leicht bewölkt;7;5;0
25.02.2020 00:00;75;15;60;Sonnig;8;7;0
25.02.2020 01:00;36;2;34;Sonnig;8;6;0
25.02.2020 02:00;33;5;28;Leicht bewölkt;8;6;0
25.02.2020 03:00;21;3;18;Leicht bewölkt;7;5;0
25.02.2020 04:00;14;7;7;Leicht bewölkt;7;5;0
25.02.2020 05:00;34;22;12;Leicht bewölkt;7;5;0
25.02.2020 06:00;122;68;54;Leicht bewölkt;6;4;0
25.02.2020 07:00;274;158;116;Leicht bewölkt;7;5;0
25.02.2020 08:00;438;241;197;Leicht bewölkt;8;6;0
25.02.2020 09:00;397;232;165;Leicht bewölkt;9;7;0
25.02.2020 10:00;364;201;163;Leicht bewölkt;9;7;0
25.02.2020 11:00;373;190;183;Leicht bewölkt;10;7;0
25.02.2020 12:00;398;163;235;Leicht bewölkt;10;7;0
25.02.2020 13:00;325;155;170;Leicht bewölkt;10;7;0
25.02.2020 14:00;291;137;154;Bedeckt;9;6;6
25.02.2020 15:00;302;133;169;Bedeckt;9;5;8
25.02.2020 16:00;369;177;192;Bedeckt;8;5;4
25.02.2020 17:00;438;238;200;Leichter Regenfall;8;4;5
25.02.2020 18:00;440;195;245;Leichter Regenfall;7;4;7
25.02.2020 19:00;310;121;189;Leichter Regenfall;7;3;4
25.02.2020 20:00;215;90;125;Leichter Regenfall;6;2;8
25.02.2020 21:00;149;70;79;Leichter Regenfall;6;2;1
25.02.2020 22:00;125;43;82;Leichter Regenfall;5;1;5
25.02.2020 23:00;76;35;41;Mäßiger Regenfall;5;1;11
26.02.2020 00:00;65;22;43;Mäßiger Regenfall;4;0;21
26.02.2020 01:00;20;3;17;Mäßiger Regenfall;4;-1;11
26.02.2020 02:00;5;2;3;Teilweise mäßiger Regenfall;3;-1;7
26.02.2020 03:00;3;2;1;Teilweise mäßiger Regenfall;3;-2;9
26.02.2020 04:00;6;6;0;Teilweise mäßiger Regenfall;3;-3;4
26.02.2020 05:00;40;28;12;Starker Schneefall;2;-3;5
26.02.2020 06:00;113;71;42;Starker Schneefall;2;-4;7
26.02.2020 07:00;292;176;116;Starker Schneefall;2;-4;4
26.02.2020 08:00;378;180;198;Stellenweise starker Schneefall;2;-4;2
26.02.2020 09:00;298;175;123;Stellenweise starker Schneefall;2;-4;3
26.02.2020 10:00;205;108;97;Stellenweise starker Schneefall;2;-4;2
26.02.2020 11:00;236;114;122;Schneesturm;2;-4;1
26.02.2020 12:00;299;116;183;Schneesturm;3;-4;2
26.02.2020 13:00;263;137;126;Schneesturm;2;-3;1
26.02.2020 14:00;290;133;157;Schneesturm;2;-3;3
26.02.2020 15:00;346;166;180;Schneesturm;2;-3;4
26.02.2020 16:00;386;179;207;Schneesturm;2;-3;2
26.02.2020 17:00;407;183;224;Mäßige bis starke Schneefälle;2;-4;2
26.02.2020 18:00;346;158;188;Mäßige bis starke Schneefälle;1;-4;2
26.02.2020 19:00;288;134;154;Mäßige bis starke Schneefälle;1;-4;1
26.02.2020 20:00;174;64;110;Mäßige bis starke Schneefälle;1;-5;1
26.02.2020 21:00;123;52;71;Mäßige bis starke Schneefälle;0;-5;1
26.02.2020 22:00;109;47;62;Mäßige bis starke Schneefälle;0;-5;0
26.02.2020 23:00;74;35;39;Mäßige bis starke Schneefälle;0;-5;1
27.02.2020 00:00;39;11;28;Mäßige bis starke Schneefälle;0;-5;3
27.02.2020 01:00;13;4;9;Mäßige bis starke Schneefälle;0;-5;1
27.02.2020 02:00;4;2;2;Mäßige bis starke Schneefälle;0;-5;1
27.02.2020 03:00;7;4;3;Mäßige bis starke Schneefälle;0;-5;2
27.02.2020 04:00;4;3;1;Mäßige bis starke Schneefälle;0;-5;1
27.02.2020 05:00;29;22;7;Mäßige bis starke Schneefälle;0;-5;0
27.02.2020 06:00;124;81;43;Mäßige bis starke Schneefälle;-1;-4;0
27.02.2020 07:00;250;142;108;Mäßige bis starke Schneefälle;0;-4;0
27.02.2020 08:00;392;193;199;Leicht bewölkt;1;-3;0
27.02.2020 09:00;321;188;133;Leicht bewölkt;1;-2;0
27.02.2020 10:00;261;135;126;Leicht bewölkt;2;-1;0
27.02.2020 11:00;298;151;147;Bewölkt;3;1;0
27.02.2020 12:00;343;150;193;Bewölkt;4;2;0
27.02.2020 13:00;323;160;163;Bewölkt;4;1;0
27.02.2020 14:00;217;87;130;Bedeckt;3;0;3
27.02.2020 15:00;232;87;145;Bedeckt;3;0;4
27.02.2020 16:00;283;145;138;Bedeckt;3;-1;2
27.02.2020 17:00;378;175;203;Stellenweise starker Schneefall;3;-2;2
27.02.2020 18:00;308;116;192;Stellenweise starker Schneefall;2;-3;2
27.02.2020 19:00;222;108;114;Stellenweise starker Schneefall;2;-4;1
27.02.2020 20:00;125;50;75;Bedeckt;2;-4;4
27.02.2020 21:00;102;48;54;Bedeckt;2;-5;5
27.02.2020 22:00;80;34;46;Bedeckt;2;-5;2
27.02.2020 23:00;52;24;28;Schneesturm;2;-5;2
28.02.2020 00:00;22;14;8;Schneesturm;1;-5;4
28.02.2020 01:00;17;5;12;Schneesturm;1;-5;2
28.02.2020 02:00;6;2;4;Bedeckt;1;-5;1
28.02.2020 03:00;4;3;1;Bedeckt;1;-5;1
28.02.2020 04:00;3;3;0;Bedeckt;0;-5;1
28.02.2020 05:00;25;19;6;Mäßige bis starke Schneefälle;0;-5;1
28.02.2020 06:00;108;65;43;Mäßige bis starke Schneefälle;-1;-6;1
28.02.2020 07:00;236;130;106;Mäßige bis starke Schneefälle;0;-5;0
28.02.2020 08:00;405;217;188;Leicht bewölkt;1;-4;0
28.02.2020 09:00;360;222;138;Leicht bewölkt;1;-3;0
28.02.2020 10:00;325;183;142;Leicht bewölkt;2;-1;0
28.02.2020 11:00;391;199;192;Mäßige bis starke Schneefälle;3;0;0
28.02.2020 12:00;420;191;229;Mäßige bis starke Schneefälle;5;2;0
28.02.2020 13:00;423;193;230;Mäßige bis starke Schneefälle;5;2;0
28.02.2020 14:00;420;205;215;Stellenweiser Regenfall;5;3;0
28.02.2020 15:00;446;224;222;Stellenweiser Regenfall;6;3;0
28.02.2020 16:00;456;213;243;Stellenweiser Regenfall;4;3;0
28.02.2020 17:00;503;228;275;Leicht bewölkt;3;2;0
28.02.2020 18:00;394;186;208;Leicht bewölkt;2;1;0
28.02.2020 19:00;325;142;183;Leicht bewölkt;1;0;0
28.02.2020 20:00;236;120;116;Bedeckt;0;-1;0
28.02.2020 21:00;158;86;72;Bedeckt;-2;-2;0
28.02.2020 22:00;154;68;86;Bedeckt;-1;-2;0
28.02.2020 23:00;142;60;82;Bedeckt;0;-2;0
29.02.2020 00:00;83;32;51;Bedeckt;0;-2;0
29.02.2020 01:00;58;14;44;Bedeckt;1;-1;0
29.02.2020 02:00;32;6;26;Bewölkt;1;-1;0
29.02.2020 03:00;21;6;15;Bewölkt;2;-1;0
29.02.2020 04:00;9;2;7;Bewölkt;2;-1;0
29.02.2020 05:00;16;9;7;Bedeckt;2;0;0
29.02.2020 06:00;31;21;10;Bedeckt;3;0;0
29.02.2020 07:00;53;31;22;Bedeckt;3;0;0
29.02.2020 08:00;131;67;64;Bewölkt;4;1;0
29.02.2020 09:00;212;125;87;Bewölkt;5;2;0
29.02.2020 10:00;301;174;127;Bewölkt;6;3;0
29.02.2020 11:00;337;193;144;Stellenweiser Regenfall;7;5;0
29.02.2020 12:00;360;188;172;Stellenweiser Regenfall;9;6;0
29.02.2020 13:00;404;205;199;Stellenweiser Regenfall;9;7;0
29.02.2020 14:00;379;194;185;Leicht bewölkt;9;7;0
29.02.2020 15:00;377;172;205;Leicht bewölkt;9;8;0
29.02.2020 16:00;350;146;204;Leicht bewölkt;8;6;0
29.02.2020 17:00;355;137;218;Bedeckt;7;5;0
29.02.2020 18:00;294;140;154;Bedeckt;6;4;0
29.02.2020 19:00;196;84;112;Bedeckt;5;3;0
29.02.2020 20:00;139;72;67;Leicht bewölkt;3;2;4
29.02.2020 21:00;105;43;62;Leicht bewölkt;2;1;5
29.02.2020 22:00;72;16;56;Leicht bewölkt;2;1;2
29.02.2020 23:00;76;29;47;Leichter Regenfall;3;2;2
01.03.2020 00:00;58;32;26;Leichter Regenfall;3;3;4
01.03.2020 01:00;39;21;18;Leichter Regenfall;4;2;2
01.03.2020 02:00;24;7;17;Bewölkt;4;2;8
01.03.2020 03:00;17;5;12;Bewölkt;4;2;11
01.03.2020 04:00;7;6;1;Bewölkt;4;2;6
01.03.2020 05:00;15;11;4;Mäßiger Regenfall;4;1;16
01.03.2020 06:00;22;15;7;Mäßiger Regenfall;4;1;21
01.03.2020 07:00;22;14;8;Mäßiger Regenfall;5;2;11
01.03.2020 08:00;44;25;19;Mäßiger Regenfall;6;3;6
01.03.2020 09:00;112;60;52;Mäßiger Regenfall;6;3;8
01.03.2020 10:00;133;81;52;Mäßiger Regenfall;7;5;4
01.03.2020 11:00;203;86;117;Stellenweiser Regenfall;8;6;0
01.03.2020 12:00;224;98;126;Stellenweiser Regenfall;9;8;0
01.03.2020 13:00;282;134;148;Stellenweiser Regenfall;10;9;0
01.03.2020 14:00;372;182;190;Leicht bewölkt;10;10;0
01.03.2020 15:00;333;169;164;Leicht bewölkt;11;11;0
01.03.2020 16:00;285;140;145;Leicht bewölkt;10;10;0
01.03.2020 17:00;313;144;169;Leicht bewölkt;9;9;0
01.03.2020 18:00;253;135;118;Leicht bewölkt;8;8;0
01.03.2020 19:00;175;89;86;Leicht bewölkt;7;6;0
01.03.2020 20:00;128;66;62;Bedeckt;6;5;7
01.03.2020 21:00;79;31;48;Bedeckt;6;3;9
01.03.2020 22:00;81;35;46;Bedeckt;5;2;5
01.03.2020 23:00;45;23;22;Mäßiger Regenfall;4;1;1
02.03.2020 00:00;18;4;14;Mäßiger Regenfall;4;0;2
02.03.2020 01:00;16;8;8;Mäßiger Regenfall;3;0;1
02.03.2020 02:00;4;1;3;Teilweise mäßiger Regenfall;3;0;3
02.03.2020 03:00;2;1;1;Teilweise mäßiger Regenfall;3;0;4
02.03.2020 04:00;7;5;2;Teilweise mäßiger Regenfall;2;0;2
02.03.2020 05:00;42;30;12;Leicht bewölkt;2;-1;0
02.03.2020 06:00;156;96;60;Leicht bewölkt;1;-1;0
02.03.2020 07:00;780;466;314;Leicht bewölkt;2;0;0
02.03.2020 08:00;601;339;262;Leicht bewölkt;3;1;0
02.03.2020 09:00;457;262;195;Leicht bewölkt;5;3;0
02.03.2020 10:00;329;168;161;Leicht bewölkt;6;4;0
02.03.2020 11:00;430;185;245;Bedeckt;7;6;0
02.03.2020 12:00;436;182;254;Bedeckt;9;7;0
02.03.2020 13:00;633;242;391;Bedeckt;9;8;0
02.03.2020 14:00;412;185;227;Bedeckt;9;8;0
02.03.2020 15:00;650;321;329;Bedeckt;10;9;0
02.03.2020 16:00;631;295;336;Bedeckt;8;7;0
02.03.2020 17:00;653;275;378;Bedeckt;7;5;1
02.03.2020 18:00;531;247;284;Bedeckt;6;3;1
02.03.2020 19:00;377;178;199;Bedeckt;6;2;1
02.03.2020 20:00;224;111;113;Nieselregen;5;1;2
02.03.2020 21:00;145;66;79;Nieselregen;4;0;3
02.03.2020 22:00;127;46;81;Nieselregen;4;0;2
02.03.2020 23:00;68;22;46;Leichter Regenfall;4;0;5
03.03.2020 00:00;29;11;18;Leichter Regenfall;4;0;11
03.03.2020 01:00;16;4;12;Leichter Regenfall;4;0;5
03.03.2020 02:00;3;1;2;Leichter Regenfall;4;0;7
03.03.2020 03:00;3;0;3;Leichter Regenfall;4;-1;1
03.03.2020 04:00;9;6;3;Leichter Regenfall;4;-1;5
03.03.2020 05:00;36;23;13;Leichter Eisregen;4;-1;3
03.03.2020 06:00;142;88;54;Leichter Eisregen;3;-1;4
03.03.2020 07:00;741;464;277;Leichter Eisregen;3;-1;2
03.03.2020 08:00;600;353;247;Bedeckt;3;-1;1
03.03.2020 09:00;423;241;182;Bedeckt;3;-1;1
03.03.2020 10:00;313;180;133;Bedeckt;4;0;0
03.03.2020 11:00;419;203;216;Mäßige bis starke Schneefälle;4;1;0
03.03.2020 12:00;486;189;297;Mäßige bis starke Schneefälle;5;2;0
03.03.2020 13:00;630;252;378;Mäßige bis starke Schneefälle;5;3;0
03.03.2020 14:00;433;210;223;Bedeckt;6;4;0
03.03.2020 15:00;676;337;339;Bedeckt;6;4;0
03.03.2020 16:00;608;294;314;Bedeckt;5;4;0
03.03.2020 17:00;695;321;374;Stellenweiser Regenfall;5;3;1
03.03.2020 18:00;605;267;338;Stellenweiser Regenfall;4;2;1
03.03.2020 19:00;469;207;262;Stellenweiser Regenfall;3;2;1
03.03.2020 20:00;295;131;164;Stellenweiser Regenfall;2;1;0
03.03.2020 21:00;186;64;122;Stellenweiser Regenfall;1;1;0
03.03.2020 22:00;204;76;128;Stellenweiser Regenfall;1;0;0
03.03.2020 23:00;79;28;51;Leicht bewölkt;1;0;0
04.03.2020 00:00;47;22;25;Leicht bewölkt;0;-1;0
04.03.2020 01:00;23;8;15;Leicht bewölkt;0;-1;0
04.03.2020 02:00;7;2;5;Stellenweise leichter Schneefall;0;-1;0
04.03.2020 03:00;9;2;7;Stellenweise leichter Schneefall;1;-1;0
04.03.2020 04:00;5;5;0;Stellenweise leichter Schneefall;1;-1;0
04.03.2020 05:00;44;26;18;Mäßige bis starke Schneefälle;1;-2;1
04.03.2020 06:00;142;89;53;Mäßige bis starke Schneefälle;1;-2;1
04.03.2020 07:00;826;501;325;Mäßige bis starke Schneefälle;1;-1;0
04.03.2020 08:00;630;342;288;Mäßige bis starke Schneefälle;2;0;0
04.03.2020 09:00;462;282;180;Mäßige bis starke Schneefälle;3;1;0
04.03.2020 10:00;321;163;158;Mäßige bis starke Schneefälle;4;2;0
04.03.2020 11:00;417;207;210;Leicht bewölkt;5;3;0
04.03.2020 12:00;495;209;286;Leicht bewölkt;6;4;0
04.03.2020 13:00;705;297;408;Leicht bewölkt;7;5;0
04.03.2020 14:00;466;224;242;Leicht bewölkt;7;6;0
04.03.2020 15:00;712;310;402;Leicht bewölkt;7;6;0
04.03.2020 16:00;649;322;327;Leicht bewölkt;7;6;0
04.03.2020 17:00;781;355;426;Bedeckt;6;6;0
04.03.2020 18:00;632;275;357;Bedeckt;6;5;0
04.03.2020 19:00;453;209;244;Bedeckt;4;4;0
04.03.2020 20:00;349;143;206;Bewölkt;3;3;0
04.03.2020 21:00;204;77;127;Bewölkt;2;1;0
04.03.2020 22:00;183;70;113;Bewölkt;2;0;0
04.03.2020 23:00;97;36;61;Leicht bewölkt;1;-1;0
05.03.2020 00:00;51;15;36;Leicht bewölkt;1;-2;0
05.03.2020 01:00;17;8;9;Leicht bewölkt;1;-1;0
05.03.2020 02:00;3;2;1;Bewölkt;1;-1;0
05.03.2020 03:00;4;0;4;Bewölkt;1;-1;0
05.03.2020 04:00;7;3;4;Bewölkt;1;-1;0
05.03.2020 05:00;46;33;13;Stellenweiser Regenfall;2;0;1
05.03.2020 06:00;131;75;56;Stellenweiser Regenfall;2;0;2
05.03.2020 07:00;753;450;303;Stellenweiser Regenfall;3;1;1
05.03.2020 08:00;568;296;272;Nieselregen;4;2;1
05.03.2020 09:00;408;225;183;Nieselregen;4;3;1
05.03.2020 10:00;247;131;116;Nieselregen;5;3;1
05.03.2020 11:00;271;144;127;Stellenweiser Regenfall;5;4;3
05.03.2020 12:00;342;162;180;Stellenweiser Regenfall;6;4;4
05.03.2020 13:00;466;152;314;Stellenweiser Regenfall;6;4;2
05.03.2020 14:00;338;157;181;Leichter Regenfall;6;4;11
05.03.2020 15:00;454;206;248;Leichter Regenfall;6;4;15
05.03.2020 16:00;392;187;205;Leichter Regenfall;6;4;7
05.03.2020 17:00;483;198;285;Mäßiger Regenfall;6;4;5
05.03.2020 18:00;429;188;241;Mäßiger Regenfall;6;4;7
05.03.2020 19:00;266;126;140;Mäßiger Regenfall;6;4;3
05.03.2020 20:00;186;78;108;Bedeckt;5;3;5
05.03.2020 21:00;139;67;72;Bedeckt;5;3;7
05.03.2020 22:00;122;44;78;Bedeckt;5;2;3
05.03.2020 23:00;57;17;40;Stellenweiser leichter Regenfall;4;1;2
06.03.2020 00:00;33;10;23;Stellenweiser leichter Regenfall;3;1;5
06.03.2020 01:00;23;9;14;Stellenweiser leichter Regenfall;4;0;2
06.03.2020 02:00;3;1;2;Leicht bewölkt;4;0;0
06.03.2020 03:00;1;0;1;Leicht bewölkt;4;0;0
06.03.2020 04:00;1;1;0;Leicht bewölkt;4;0;0
06.03.2020 05:00;46;29;17;Stellenweiser Nieselregen;4;-1;1
06.03.2020 06:00;111;60;51;Stellenweiser Nieselregen;4;-1;1
06.03.2020 07:00;658;404;254;Stellenweiser Nieselregen;4;-1;0
06.03.2020 08:00;502;285;217;Leichter Regenschauer;5;0;0
06.03.2020 09:00;399;243;156;Leichter Regenschauer;5;0;0
06.03.2020 10:00;296;155;141;Leichter Regenschauer;6;1;0
06.03.2020 11:00;381;193;188;Leicht bewölkt;6;2;0
06.03.2020 12:00;520;241;279;Leicht bewölkt;7;3;0
06.03.2020 13:00;643;232;411;Leicht bewölkt;7;3;0
06.03.2020 14:00;432;216;216;Bewölkt;7;3;0
06.03.2020 15:00;432;183;249;Bewölkt;7;3;0
06.03.2020 16:00;478;210;268;Bewölkt;6;2;0
06.03.2020 17:00;458;207;251;Leichter Regenschauer;5;2;0
06.03.2020 18:00;377;182;195;Leichter Regenschauer;5;1;0
06.03.2020 19:00;322;155;167;Leichter Regenschauer;4;0;0
06.03.2020 20:00;209;107;102;Bedeckt;4;0;1
06.03.2020 21:00;168;91;77;Bedeckt;4;0;1
06.03.2020 22:00;151;65;86;Bedeckt;3;0;1
06.03.2020 23:00;126;46;80;Leichter Eisregen;3;0;1
07.03.2020 00:00;71;23;48;Leichter Eisregen;3;0;3
07.03.2020 01:00;52;17;35;Leichter Eisregen;3;0;1
07.03.2020 02:00;33;8;25;Leichter Eisregen;3;0;2
07.03.2020 03:00;16;9;7;Leichter Eisregen;3;0;3
07.03.2020 04:00;17;12;5;Leichter Eisregen;3;0;2
07.03.2020 05:00;24;17;7;Leichter Eisregen;3;0;5
07.03.2020 06:00;30;18;12;Leichter Eisregen;3;0;7
07.03.2020 07:00;57;29;28;Leichter Eisregen;3;1;4
07.03.2020 08:00;125;66;59;Starker Schneefall;3;1;4
07.03.2020 09:00;264;168;96;Starker Schneefall;4;1;5
07.03.2020 10:00;335;188;147;Starker Schneefall;4;2;2
07.03.2020 11:00;420;221;199;Stellenweiser Eisregen;5;3;2
07.03.2020 12:00;402;217;185;Stellenweiser Eisregen;6;3;3
07.03.2020 13:00;342;172;170;Stellenweiser Eisregen;6;4;2
07.03.2020 14:00;404;193;211;Leichter Regenschauer;6;4;3
07.03.2020 15:00;393;173;220;Leichter Regenschauer;7;5;4
07.03.2020 16:00;327;146;181;Leichter Regenschauer;6;4;2
07.03.2020 17:00;391;179;212;Stellenweiser Regenfall;5;3;2
07.03.2020 18:00;343;145;198;Stellenweiser Regenfall;4;2;2
07.03.2020 19:00;251;132;119;Stellenweiser Regenfall;3;2;1
07.03.2020 20:00;236;125;111;Leichter Regenschauer;2;1;1
07.03.2020 21:00;175;96;79;Leichter Regenschauer;2;1;1
07.03.2020 22:00;138;57;81;Leichter Regenschauer;1;0;0
07.03.2020 23:00;124;55;69;Leichter Regenschauer;1;0;1
08.03.2020 00:00;99;21;78;Leichter Regenschauer;0;-1;1
08.03.2020 01:00;82;26;56;Leichter Regenschauer;0;-2;1
08.03.2020 02:00;56;20;36;Mäßige bis starke Schneefälle;-1;-2;0
08.03.2020 03:00;48;19;29;Mäßige bis starke Schneefälle;-1;-3;0
08.03.2020 04:00;29;15;14;Mäßige bis starke Schneefälle;-1;-3;0
08.03.2020 05:00;21;7;14;Leicht bewölkt;-1;-3;0
08.03.2020 06:00;17;11;6;Leicht bewölkt;-1;-4;0
08.03.2020 07:00;22;18;4;Leicht bewölkt;0;-2;0
08.03.2020 08:00;44;25;19;Leicht bewölkt;2;-1;0
08.03.2020 09:00;145;80;65;Leicht bewölkt;3;1;0
08.03.2020 10:00;165;84;81;Leicht bewölkt;4;3;0
08.03.2020 11:00;239;92;147;Leicht bewölkt;6;5;0
08.03.2020 12:00;265;128;137;Leicht bewölkt;8;7;0
08.03.2020 13:00;294;161;133;Leicht bewölkt;8;7;0
08.03.2020 14:00;341;182;159;Leicht bewölkt;8;8;0
08.03.2020 15:00;342;164;178;Leicht bewölkt;9;8;0
08.03.2020 16:00;316;132;184;Leicht bewölkt;8;8;0
08.03.2020 17:00;304;148;156;Bedeckt;8;7;0
08.03.2020 18:00;227;89;138;Bedeckt;7;7;0
08.03.2020 19:00;153;84;69;Bedeckt;6;6;0
08.03.2020 20:00;150;73;77;Leicht bewölkt;5;4;0
08.03.2020 21:00;87;37;50;Leicht bewölkt;4;3;0
08.03.2020 22:00;90;31;59;Leicht bewölkt;3;2;0
08.03.2020 23:00;40;16;24;Bedeckt;3;1;0
09.03.2020 00:00;19;8;11;Bedeckt;2;1;1
09.03.2020 01:00;13;7;6;Bedeckt;3;1;0
09.03.2020 02:00;2;0;2;Stellenweiser Regenfall;3;1;3
09.03.2020 03:00;5;5;0;Stellenweiser Regenfall;3;1;4
09.03.2020 04:00;5;2;3;Stellenweiser Regenfall;4;1;2
09.03.2020 05:00;45;30;15;Leichter Regenfall;4;1;4
09.03.2020 06:00;150;97;53;Leichter Regenfall;4;1;5
09.03.2020 07:00;665;394;271;Leichter Regenfall;4;1;2
09.03.2020 08:00;565;323;242;Leichter Regenfall;4;1;5
09.03.2020 09:00;331;200;131;Leichter Regenfall;5;1;7
09.03.2020 10:00;228;118;110;Leichter Regenfall;5;2;3
09.03.2020 11:00;315;144;171;Leichter Regenfall;5;3;7
09.03.2020 12:00;387;164;223;Leichter Regenfall;6;3;9
09.03.2020 13:00;594;282;312;Leichter Regenfall;6;3;5
09.03.2020 14:00;400;195;205;Leichter Regenfall;6;3;6
09.03.2020 15:00;628;310;318;Leichter Regenfall;6;4;8
09.03.2020 16:00;584;274;310;Leichter Regenfall;6;3;4
09.03.2020 17:00;627;302;325;Leichter Regenschauer;5;2;4
09.03.2020 18:00;458;221;237;Leichter Regenschauer;4;2;6
09.03.2020 19:00;378;169;209;Leichter Regenschauer;4;1;3
09.03.2020 20:00;251;106;145;Leichter Regenschauer;3;0;2
09.03.2020 21:00;168;59;109;Leichter Regenschauer;2;-1;2
09.03.2020 22:00;111;51;60;Leichter Regenschauer;2;-1;1
09.03.2020 23:00;58;23;35;Stellenweiser Regenfall;1;-1;0
10.03.2020 00:00;28;10;18;Stellenweiser Regenfall;1;-2;1
10.03.2020 01:00;24;14;10;Stellenweiser Regenfall;1;-2;0
10.03.2020 02:00;6;3;3;Leichter Eisregen;1;-2;0
10.03.2020 03:00;6;5;1;Leichter Eisregen;1;-2;0
10.03.2020 04:00;6;6;0;Leichter Eisregen;1;-1;0
10.03.2020 05:00;41;32;9;Leicht bewölkt;1;-1;0
10.03.2020 06:00;148;99;49;Leicht bewölkt;2;-1;0
10.03.2020 07:00;765;436;329;Leicht bewölkt;2;0;0
10.03.2020 08:00;536;315;221;Bedeckt;3;0;3
10.03.2020 09:00;389;220;169;Bedeckt;3;0;4
10.03.2020 10:00;210;113;97;Bedeckt;3;0;2
10.03.2020 11:00;289;144;145;Leichter Eisregen;4;1;5
10.03.2020 12:00;342;134;208;Leichter Eisregen;4;1;7
10.03.2020 13:00;479;187;292;Leichter Eisregen;4;1;3
10.03.2020 14:00;275;115;160;Leichter Regenfall;4;2;14
10.03.2020 15:00;515;215;300;Leichter Regenfall;5;2;19
10.03.2020 16:00;498;252;246;Leichter Regenfall;4;2;1
10.03.2020 17:00;544;264;280;Mäßiger Regenfall;3;2;2
10.03.2020 18:00;450;203;247;Mäßiger Regenfall;3;2;26
10.03.2020 19:00;366;163;203;Mäßiger Regenfall;2;1;13
10.03.2020 20:00;200;88;112;Mäßiger Regenfall;1;0;9
10.03.2020 21:00;173;73;100;Mäßiger Regenfall;0;0;12
10.03.2020 22:00;136;43;93;Mäßiger Regenfall;1;1;6
10.03.2020 23:00;51;17;34;Leichter Regenfall;3;2;2
11.03.2020 00:00;31;7;24;Leichter Regenfall;5;4;4
11.03.2020 01:00;7;3;4;Leichter Regenfall;6;4;2
11.03.2020 02:00;6;1;5;Nieselregen;7;5;1
11.03.2020 03:00;6;5;1;Nieselregen;8;6;1
11.03.2020 04:00;9;8;1;Nieselregen;9;6;1
11.03.2020 05:00;49;35;14;Nieselregen;9;6;0
11.03.2020 06:00;144;82;62;Nieselregen;9;6;0
11.03.2020 07:00;819;484;335;Nieselregen;10;7;0
11.03.2020 08:00;696;407;289;Stellenweiser Regenfall;10;8;0
11.03.2020 09:00;576;347;229;Stellenweiser Regenfall;11;8;0
11.03.2020 10:00;366;184;182;Stellenweiser Regenfall;12;10;0
11.03.2020 11:00;410;216;194;Bewölkt;13;11;0
11.03.2020 12:00;521;228;293;Bewölkt;13;12;0
11.03.2020 13:00;738;338;400;Bewölkt;14;13;0
11.03.2020 14:00;559;276;283;Leicht bewölkt;14;14;1
11.03.2020 15:00;796;339;457;Leicht bewölkt;15;14;1
11.03.2020 16:00;754;355;399;Leicht bewölkt;14;13;0
11.03.2020 17:00;770;342;428;Leichter Regenschauer;13;13;1
11.03.2020 18:00;634;285;349;Leichter Regenschauer;12;12;2
11.03.2020 19:00;488;238;250;Leichter Regenschauer;12;11;1
11.03.2020 20:00;375;151;224;Leichter Regenschauer;11;10;1
11.03.2020 21:00;192;96;96;Leichter Regenschauer;10;9;1
11.03.2020 22:00;174;78;96;Leichter Regenschauer;10;8;0
11.03.2020 23:00;127;55;72;Stellenweiser Regenfall;9;8;0
12.03.2020 00:00;37;20;17;Stellenweiser Regenfall;9;7;1
12.03.2020 01:00;24;5;19;Stellenweiser Regenfall;8;7;0
12.03.2020 02:00;4;2;2;Stellenweiser Regenfall;8;6;0
12.03.2020 03:00;10;4;6;Stellenweiser Regenfall;7;6;0
12.03.2020 04:00;6;6;0;Stellenweiser Regenfall;7;6;0
12.03.2020 05:00;36;26;10;Leicht bewölkt;7;6;0
12.03.2020 06:00;153;94;59;Leicht bewölkt;8;6;0
12.03.2020 07:00;843;504;339;Leicht bewölkt;8;7;0
12.03.2020 08:00;666;374;292;Bedeckt;9;8;0
12.03.2020 09:00;574;339;235;Bedeckt;10;8;0
12.03.2020 10:00;332;192;140;Bedeckt;11;9;0
12.03.2020 11:00;418;217;201;Bedeckt;12;10;0
12.03.2020 12:00;501;216;285;Bedeckt;13;11;0
12.03.2020 13:00;710;272;438;Bedeckt;13;12;0
12.03.2020 14:00;536;248;288;Bedeckt;13;12;0
12.03.2020 15:00;768;392;376;Bedeckt;13;12;0
12.03.2020 16:00;719;329;390;Bedeckt;13;12;0
12.03.2020 17:00;822;360;462;Bedeckt;12;11;0
12.03.2020 18:00;684;340;344;Bedeckt;12;11;0
12.03.2020 19:00;389;191;198;Bedeckt;12;10;0
12.03.2020 20:00;317;143;174;Leicht bewölkt;11;9;1
12.03.2020 21:00;204;72;132;Leicht bewölkt;10;9;1
12.03.2020 22:00;159;65;94;Leicht bewölkt;10;8;0
12.03.2020 23:00;94;28;66;Nieselregen;9;7;1
13.03.2020 00:00;51;22;29;Nieselregen;9;7;1
13.03.2020 01:00;29;15;14;Nieselregen;8;6;1
13.03.2020 02:00;12;4;8;Nieselregen;8;6;1
13.03.2020 03:00;5;2;3;Nieselregen;7;5;1
13.03.2020 04:00;6;4;2;Nieselregen;7;5;1
13.03.2020 05:00;35;25;10;Nieselregen;7;4;1
13.03.2020 06:00;119;73;46;Nieselregen;6;3;1
13.03.2020 07:00;745;437;308;Nieselregen;6;3;1
13.03.2020 08:00;586;367;219;Stellenweiser Nieselregen;6;3;1
13.03.2020 09:00;539;335;204;Stellenweiser Nieselregen;6;3;1
13.03.2020 10:00;366;205;161;Stellenweiser Nieselregen;7;4;0
13.03.2020 11:00;480;238;242;Nieselregen;8;5;1
13.03.2020 12:00;659;307;352;Nieselregen;8;6;1
13.03.2020 13:00;739;269;470;Nieselregen;9;6;1
13.03.2020 14:00;638;303;335;Stellenweiser Regenfall;9;7;0
13.03.2020 15:00;621;310;311;Stellenweiser Regenfall;9;7;0
13.03.2020 16:00;673;301;372;Stellenweiser Regenfall;8;6;0
13.03.2020 17:00;641;282;359;Leicht bewölkt;7;6;0
13.03.2020 18:00;549;201;348;Leicht bewölkt;6;5;0
13.03.2020 19:00;413;202;211;Leicht bewölkt;5;4;0
13.03.2020 20:00;243;123;120;Leicht bewölkt;4;4;0
13.03.2020 21:00;169;78;91;Leicht bewölkt;3;3;0
13.03.2020 22:00;127;56;71;Leicht bewölkt;3;3;0
13.03.2020 23:00;130;54;76;Leicht bewölkt;2;2;0
14.03.2020 00:00;84;32;52;Leicht bewölkt;2;2;0
14.03.2020 01:00;76;26;50;Leicht bewölkt;2;1;0
14.03.2020 02:00;42;26;16;Bedeckt;2;1;0
14.03.2020 03:00;23;9;14;Bedeckt;1;1;0
14.03.2020 04:00;9;6;3;Bedeckt;2;1;0
14.03.2020 05:00;22;16;6;Leicht bewölkt;2;1;0
14.03.2020 06:00;30;18;12;Leicht bewölkt;2;1;0
14.03.2020 07:00;64;32;32;Leicht bewölkt;3;2;0
14.03.2020 08:00;154;88;66;Leicht bewölkt;4;4;0
14.03.2020 09:00;302;185;117;Leicht bewölkt;5;5;0
14.03.2020 10:00;373;198;175;Leicht bewölkt;7;6;0
14.03.2020 11:00;430;234;196;Leicht bewölkt;8;8;0
14.03.2020 12:00;428;217;211;Leicht bewölkt;9;9;0
14.03.2020 13:00;448;216;232;Leicht bewölkt;10;10;0
14.03.2020 14:00;445;196;249;Leicht bewölkt;10;10;0
14.03.2020 15:00;395;185;210;Leicht bewölkt;10;10;0
14.03.2020 16:00;365;171;194;Leicht bewölkt;9;9;0
14.03.2020 17:00;339;152;187;Leichter Regenschauer;9;9;0
14.03.2020 18:00;297;107;190;Leichter Regenschauer;8;8;0
14.03.2020 19:00;207;91;116;Leichter Regenschauer;7;7;0
14.03.2020 20:00;173;85;88;Leicht bewölkt;7;7;0
14.03.2020 21:00;99;42;57;Leicht bewölkt;6;6;0
14.03.2020 22:00;97;36;61;Leicht bewölkt;5;5;0
14.03.2020 23:00;93;38;55;Leicht bewölkt;4;4;0
15.03.2020 00:00;61;38;23;Leicht bewölkt;3;3;0
15.03.2020 01:00;54;16;38;Leicht bewölkt;2;2;0
15.03.2020 02:00;31;11;20;Leicht bewölkt;2;1;0
15.03.2020 03:00;21;7;14;Leicht bewölkt;2;1;0
15.03.2020 04:00;7;3;4;Leicht bewölkt;1;1;0
15.03.2020 05:00;14;7;7;Leicht bewölkt;1;0;0
15.03.2020 06:00;29;18;11;Leicht bewölkt;1;0;0
15.03.2020 07:00;25;14;11;Leicht bewölkt;3;2;0
15.03.2020 08:00;60;36;24;Leicht bewölkt;5;4;0
15.03.2020 09:00;115;58;57;Leicht bewölkt;7;6;0
15.03.2020 10:00;179;95;84;Leicht bewölkt;8;8;0
15.03.2020 11:00;264;124;140;Leicht bewölkt;10;10;0
15.03.2020 12:00;343;162;181;Leicht bewölkt;12;12;0
15.03.2020 13:00;436;185;251;Leicht bewölkt;13;13;0
15.03.2020 14:00;494;191;303;Leicht bewölkt;13;14;0
15.03.2020 15:00;449;242;207;Leicht bewölkt;14;14;0
15.03.2020 16:00;530;304;226;Leicht bewölkt;13;14;0
15.03.2020 17:00;427;226;201;Leicht bewölkt;13;13;0
15.03.2020 18:00;316;143;173;Leicht bewölkt;12;12;0
15.03.2020 19:00;165;86;79;Leicht bewölkt;11;11;0
15.03.2020 20:00;110;51;59;Leicht bewölkt;10;10;0
15.03.2020 21:00;89;41;48;Leicht bewölkt;9;9;0
15.03.2020 22:00;51;25;26;Leicht bewölkt;7;7;0
15.03.2020 23:00;35;20;15;Leicht bewölkt;6;5;0
16.03.2020 00:00;29;19;10;Leicht bewölkt;4;3;0
16.03.2020 01:00;7;3;4;Leicht bewölkt;3;2;0
16.03.2020 02:00;5;5;0;Leicht bewölkt;3;1;0
16.03.2020 03:00;1;0;1;Leicht bewölkt;2;0;0
16.03.2020 04:00;5;3;2;Leicht bewölkt;2;0;0
16.03.2020 05:00;34;18;16;Leicht bewölkt;2;0;0
16.03.2020 06:00;152;98;54;Leicht bewölkt;2;1;0
16.03.2020 07:00;590;299;291;Leicht bewölkt;4;3;0
16.03.2020 08:00;710;466;244;Leicht bewölkt;6;5;0
16.03.2020 09:00;579;297;282;Leicht bewölkt;8;7;0
16.03.2020 10:00;447;234;213;Leicht bewölkt;10;10;0
16.03.2020 11:00;584;291;293;Leicht bewölkt;12;12;0
16.03.2020 12:00;487;218;269;Leicht bewölkt;14;14;0
16.03.2020 13:00;491;211;280;Leicht bewölkt;14;14;0
16.03.2020 14:00;521;252;269;Leicht bewölkt;15;15;0
16.03.2020 15:00;602;312;290;Leicht bewölkt;15;15;0
16.03.2020 16:00;674;314;360;Leicht bewölkt;14;14;0
16.03.2020 17:00;670;297;373;Leicht bewölkt;13;13;0
16.03.2020 18:00;512;205;307;Leicht bewölkt;13;13;0
16.03.2020 19:00;296;116;180;Leicht bewölkt;11;11;0
16.03.2020 20:00;158;62;96;Leicht bewölkt;10;10;0
16.03.2020 21:00;107;48;59;Leicht bewölkt;9;9;0
16.03.2020 22:00;72;37;35;Leicht bewölkt;7;7;0
16.03.2020 23:00;54;26;28;Leicht bewölkt;6;6;0
17.03.2020 00:00;21;6;15;Leicht bewölkt;5;5;0
17.03.2020 01:00;18;12;6;Leicht bewölkt;5;4;0
17.03.2020 02:00;7;2;5;Leicht bewölkt;5;4;0
17.03.2020 03:00;6;3;3;Leicht bewölkt;4;4;0
17.03.2020 04:00;7;5;2;Leicht bewölkt;4;4;0
17.03.2020 05:00;42;33;9;Leicht bewölkt;4;4;0
17.03.2020 06:00;139;90;49;Leicht bewölkt;4;4;0
17.03.2020 07:00;353;229;124;Leicht bewölkt;6;5;0
17.03.2020 08:00;393;280;113;Leicht bewölkt;8;7;0
17.03.2020 09:00;383;219;164;Leicht bewölkt;9;9;0
17.03.2020 10:00;362;183;179;Leicht bewölkt;11;11;0
17.03.2020 11:00;394;188;206;Leicht bewölkt;13;13;0
17.03.2020 12:00;428;196;232;Leicht bewölkt;14;14;0
17.03.2020 13:00;417;181;236;Leicht bewölkt;15;15;0
17.03.2020 14:00;452;205;247;Leicht bewölkt;15;15;0
17.03.2020 15:00;496;230;266;Leicht bewölkt;16;16;0
17.03.2020 16:00;572;255;317;Leicht bewölkt;15;15;0
17.03.2020 17:00;548;249;299;Leicht bewölkt;14;14;0
17.03.2020 18:00;467;182;285;Leicht bewölkt;13;13;0
17.03.2020 19:00;209;87;122;Leicht bewölkt;12;12;0
17.03.2020 20:00;119;43;76;Leicht bewölkt;10;10;0
17.03.2020 21:00;82;34;48;Leicht bewölkt;9;9;0
17.03.2020 22:00;60;35;25;Leicht bewölkt;8;8;0
17.03.2020 23:00;42;24;18;Bedeckt;8;8;0
18.03.2020 00:00;30;16;14;Bedeckt;7;7;0
18.03.2020 01:00;13;5;8;Bedeckt;7;7;0
18.03.2020 02:00;5;2;3;Leicht bewölkt;6;6;0
18.03.2020 03:00;4;3;1;Leicht bewölkt;6;6;0
18.03.2020 04:00;11;8;3;Leicht bewölkt;6;6;0
18.03.2020 05:00;49;33;16;Leicht bewölkt;5;5;0
18.03.2020 06:00;152;99;53;Leicht bewölkt;5;5;0
18.03.2020 07:00;316;199;117;Leicht bewölkt;7;7;0
18.03.2020 08:00;303;207;96;Leicht bewölkt;9;9;0
18.03.2020 09:00;328;188;140;Leicht bewölkt;11;11;0
18.03.2020 10:00;311;169;142;Leicht bewölkt;13;13;0
18.03.2020 11:00;365;191;174;Leicht bewölkt;14;14;0
18.03.2020 12:00;461;200;261;Leicht bewölkt;16;16;0
18.03.2020 13:00;403;177;226;Leicht bewölkt;17;17;0
18.03.2020 14:00;485;205;280;Leicht bewölkt;17;17;0
18.03.2020 15:00;520;222;298;Leicht bewölkt;17;17;0
18.03.2020 16:00;611;266;345;Leicht bewölkt;16;16;0
18.03.2020 17:00;571;250;321;Leicht bewölkt;16;16;0
18.03.2020 18:00;529;265;264;Leicht bewölkt;15;15;0
18.03.2020 19:00;245;109;136;Leicht bewölkt;14;14;0
18.03.2020 20:00;127;61;66;Leicht bewölkt;12;12;0
18.03.2020 21:00;76;33;43;Leicht bewölkt;11;11;0
18.03.2020 22:00;58;28;30;Leicht bewölkt;10;10;0
18.03.2020 23:00;29;12;17;Leicht bewölkt;9;9;0
19.03.2020 00:00;22;10;12;Leicht bewölkt;8;8;0
19.03.2020 01:00;11;3;8;Leicht bewölkt;7;7;0
19.03.2020 02:00;7;5;2;Leicht bewölkt;7;7;0
19.03.2020 03:00;7;4;3;Leicht bewölkt;6;6;0
19.03.2020 04:00;8;4;4;Leicht bewölkt;6;6;0
19.03.2020 05:00;48;32;16;Leicht bewölkt;6;6;0
19.03.2020 06:00;139;89;50;Leicht bewölkt;6;6;0
19.03.2020 07:00;299;184;115;Leicht bewölkt;8;8;0
19.03.2020 08:00;309;202;107;Leicht bewölkt;10;10;0
19.03.2020 09:00;288;148;140;Leicht bewölkt;11;11;0
19.03.2020 10:00;290;144;146;Leicht bewölkt;13;13;0
19.03.2020 11:00;337;156;181;Leicht bewölkt;15;15;0
19.03.2020 12:00;374;166;208;Leicht bewölkt;17;17;0
19.03.2020 13:00;380;181;199;Leicht bewölkt;17;17;0
19.03.2020 14:00;464;224;240;Leicht bewölkt;18;18;0
19.03.2020 15:00;479;231;248;Leicht bewölkt;18;18;0
19.03.2020 16:00;538;227;311;Leicht bewölkt;18;18;0
19.03.2020 17:00;568;262;306;Leicht bewölkt;17;17;0
19.03.2020 18:00;470;213;257;Leicht bewölkt;17;17;0
19.03.2020 19:00;237;105;132;Leicht bewölkt;16;16;0
19.03.2020 20:00;112;48;64;Leicht bewölkt;16;16;0
19.03.2020 21:00;56;25;31;Leicht bewölkt;15;15;0
19.03.2020 22:00;45;23;22;Leicht bewölkt;13;13;0
19.03.2020 23:00;34;18;16;Leicht bewölkt;11;11;0
20.03.2020 00:00;18;5;13;Leicht bewölkt;10;10;0
20.03.2020 01:00;7;2;5;Leicht bewölkt;9;9;0
20.03.2020 02:00;5;1;4;Leicht bewölkt;8;8;0
20.03.2020 03:00;4;3;1;Leicht bewölkt;7;7;0
20.03.2020 04:00;11;9;2;Leicht bewölkt;6;6;0
20.03.2020 05:00;38;29;9;Leicht bewölkt;6;6;0
20.03.2020 06:00;111;74;37;Leicht bewölkt;6;5;0
20.03.2020 07:00;271;182;89;Leicht bewölkt;7;7;0
20.03.2020 08:00;300;206;94;Leicht bewölkt;9;9;0
20.03.2020 09:00;330;182;148;Leicht bewölkt;11;11;0
20.03.2020 10:00;340;164;176;Leicht bewölkt;13;13;0
20.03.2020 11:00;366;161;205;Leicht bewölkt;14;14;0
20.03.2020 12:00;389;154;235;Leicht bewölkt;16;16;0
20.03.2020 13:00;431;196;235;Leicht bewölkt;17;17;0
20.03.2020 14:00;399;161;238;Leicht bewölkt;17;17;2
20.03.2020 15:00;456;218;238;Leicht bewölkt;18;18;2
20.03.2020 16:00;461;203;258;Leicht bewölkt;17;17;1
20.03.2020 17:00;422;202;220;Stellenweiser Regenfall;17;17;5
20.03.2020 18:00;308;146;162;Stellenweiser Regenfall;17;17;7
20.03.2020 19:00;161;85;76;Stellenweiser Regenfall;16;16;3
20.03.2020 20:00;98;51;47;Leichter Regenschauer;15;15;7
20.03.2020 21:00;64;36;28;Leichter Regenschauer;15;15;9
20.03.2020 22:00;39;11;28;Leichter Regenschauer;13;13;5
20.03.2020 23:00;40;21;19;Leichter Regenschauer;12;12;12
21.03.2020 00:00;16;10;6;Leichter Regenschauer;11;11;25
21.03.2020 01:00;11;5;6;Leichter Regenschauer;10;10;12
21.03.2020 02:00;10;3;7;Mäßiger Regenfall;10;9;5
21.03.2020 03:00;2;2;0;Mäßiger Regenfall;9;8;7
21.03.2020 04:00;8;7;1;Mäßiger Regenfall;9;8;3
21.03.2020 05:00;17;9;8;Leichter Nebel;8;7;0
21.03.2020 06:00;27;14;13;Leichter Nebel;8;7;0
21.03.2020 07:00;50;21;29;Leichter Nebel;8;7;0
21.03.2020 08:00;86;38;48;Leichter Nebel;8;7;0
21.03.2020 09:00;144;81;63;Leichter Nebel;8;6;0
21.03.2020 10:00;156;71;85;Leichter Nebel;8;6;0
21.03.2020 11:00;202;88;114;Bedeckt;8;6;0
21.03.2020 12:00;205;92;113;Bedeckt;8;6;0
21.03.2020 13:00;198;101;97;Bedeckt;8;6;0
21.03.2020 14:00;192;88;104;Bedeckt;8;5;0
21.03.2020 15:00;164;69;95;Bedeckt;8;5;0
21.03.2020 16:00;214;93;121;Bedeckt;7;5;0
21.03.2020 17:00;186;95;91;Bedeckt;7;4;0
21.03.2020 18:00;109;47;62;Bedeckt;7;3;0
21.03.2020 19:00;83;39;44;Bedeckt;6;3;0
21.03.2020 20:00;68;32;36;Bedeckt;6;2;1
21.03.2020 21:00;39;23;16;Bedeckt;5;2;1
21.03.2020 22:00;25;12;13;Bedeckt;5;1;0
21.03.2020 23:00;25;19;6;Nieselregen;5;1;1
22.03.2020 00:00;9;6;3;Nieselregen;5;1;1
22.03.2020 01:00;9;4;5;Nieselregen;4;0;1
22.03.2020 02:00;7;4;3;Nieselregen;4;0;0
22.03.2020 03:00;2;1;1;Nieselregen;4;-1;0
22.03.2020 04:00;2;2;0;Nieselregen;3;-1;0
22.03.2020 05:00;13;4;9;Bewölkt;3;-2;0
22.03.2020 06:00;12;8;4;Bewölkt;2;-2;0
22.03.2020 07:00;11;4;7;Bewölkt;3;-2;0
22.03.2020 08:00;24;9;15;Leicht bewölkt;3;-1;0
22.03.2020 09:00;43;17;26;Leicht bewölkt;4;-1;0
22.03.2020 10:00;71;33;38;Leicht bewölkt;5;1;0
22.03.2020 11:00;71;27;44;Leicht bewölkt;6;2;0
22.03.2020 12:00;92;44;48;Leicht bewölkt;7;4;0
22.03.2020 13:00;123;41;82;Leicht bewölkt;8;4;0
22.03.2020 14:00;228;96;132;Sonnig;8;4;0
22.03.2020 15:00;290;141;149;Sonnig;8;5;0
22.03.2020 16:00;238;123;115;Sonnig;7;4;0
22.03.2020 17:00;215;122;93;Sonnig;6;4;0
22.03.2020 18:00;140;81;59;Sonnig;6;4;0
22.03.2020 19:00;91;42;49;Sonnig;4;2;0
22.03.2020 20:00;63;36;27;Sonnig;3;0;0
22.03.2020 21:00;38;16;22;Sonnig;1;-3;0
22.03.2020 22:00;24;14;10;Sonnig;1;-4;0
22.03.2020 23:00;14;9;5;Sonnig;0;-5;0
23.03.2020 00:00;15;8;7;Sonnig;-1;-7;0
23.03.2020 01:00;7;3;4;Sonnig;-1;-7;0
23.03.2020 02:00;3;1;2;Sonnig;-2;-8;0
23.03.2020 03:00;3;2;1;Sonnig;-2;-8;0
23.03.2020 04:00;7;5;2;Sonnig;-2;-8;0
23.03.2020 05:00;27;18;9;Sonnig;-3;-8;0
23.03.2020 06:00;125;91;34;Sonnig;-3;-9;0
23.03.2020 07:00;254;152;102;Sonnig;-2;-7;0
23.03.2020 08:00;250;160;90;Sonnig;0;-6;0
23.03.2020 09:00;189;106;83;Sonnig;1;-4;0
23.03.2020 10:00;179;87;92;Sonnig;3;-2;0
23.03.2020 11:00;235;110;125;Sonnig;4;0;0
23.03.2020 12:00;279;116;163;Sonnig;6;1;0
23.03.2020 13:00;275;115;160;Sonnig;6;2;0
23.03.2020 14:00;282;137;145;Sonnig;7;2;0
23.03.2020 15:00;323;156;167;Sonnig;7;3;0
23.03.2020 16:00;383;163;220;Sonnig;6;3;0
23.03.2020 17:00;341;155;186;Sonnig;5;3;0
23.03.2020 18:00;283;122;161;Sonnig;4;3;0
23.03.2020 19:00;171;81;90;Sonnig;3;1;0
23.03.2020 20:00;63;30;33;Sonnig;2;-1;0
23.03.2020 21:00;65;28;37;Sonnig;0;-3;0
23.03.2020 22:00;25;10;15;Sonnig;0;-5;0
23.03.2020 23:00;13;9;4;Sonnig;-1;-6;0
24.03.2020 00:00;13;7;6;Sonnig;-2;-7;0
24.03.2020 01:00;17;10;7;Sonnig;-2;-7;0
24.03.2020 02:00;8;3;5;Sonnig;-2;-8;0
24.03.2020 03:00;2;2;0;Sonnig;-3;-8;0
24.03.2020 04:00;6;6;0;Sonnig;-3;-8;0
24.03.2020 05:00;25;14;11;Sonnig;-3;-8;0
24.03.2020 06:00;109;71;38;Sonnig;-3;-8;0
24.03.2020 07:00;239;151;88;Sonnig;-2;-7;0
24.03.2020 08:00;237;156;81;Sonnig;0;-5;0
24.03.2020 09:00;229;130;99;Sonnig;1;-4;0
24.03.2020 10:00;194;99;95;Sonnig;2;-2;0
24.03.2020 11:00;218;104;114;Sonnig;4;-1;0
24.03.2020 12:00;238;114;124;Sonnig;5;1;0
24.03.2020 13:00;295;109;186;Sonnig;6;2;0
24.03.2020 14:00;300;139;161;Sonnig;6;2;0
24.03.2020 15:00;326;132;194;Sonnig;7;3;0
24.03.2020 16:00;384;185;199;Sonnig;6;3;0
24.03.2020 17:00;384;177;207;Sonnig;5;3;0
24.03.2020 18:00;284;111;173;Sonnig;4;3;0
24.03.2020 19:00;143;59;84;Sonnig;3;1;0
24.03.2020 20:00;55;22;33;Sonnig;2;-1;0
24.03.2020 21:00;47;30;17;Sonnig;1;-3;0
24.03.2020 22:00;30;15;15;Sonnig;0;-4;0
24.03.2020 23:00;16;6;10;Sonnig;-1;-5;0
25.03.2020 00:00;8;3;5;Sonnig;-1;-7;0
25.03.2020 01:00;11;10;1;Sonnig;-2;-7;0
25.03.2020 02:00;2;1;1;Sonnig;-2;-7;0
25.03.2020 03:00;1;1;0;Sonnig;-3;-8;0
25.03.2020 04:00;12;10;2;Sonnig;-3;-8;0
25.03.2020 05:00;24;17;7;Sonnig;-3;-8;0
25.03.2020 06:00;116;74;42;Sonnig;-3;-8;0
25.03.2020 07:00;216;136;80;Sonnig;-2;-6;0
25.03.2020 08:00;220;143;77;Leicht bewölkt;0;-5;0
25.03.2020 09:00;175;85;90;Leicht bewölkt;1;-3;0
25.03.2020 10:00;173;83;90;Leicht bewölkt;2;-2;0
25.03.2020 11:00;208;96;112;Leicht bewölkt;4;0;0
25.03.2020 12:00;258;120;138;Leicht bewölkt;5;1;0
25.03.2020 13:00;231;112;119;Leicht bewölkt;5;2;0
25.03.2020 14:00;286;106;180;Leicht bewölkt;6;2;0
25.03.2020 15:00;263;112;151;Leicht bewölkt;6;2;0
25.03.2020 16:00;386;169;217;Leicht bewölkt;6;3;0
25.03.2020 17:00;338;142;196;Leicht bewölkt;6;3;0
25.03.2020 18:00;233;99;134;Leicht bewölkt;5;4;0
25.03.2020 19:00;134;59;75;Leicht bewölkt;4;3;0
25.03.2020 20:00;63;31;32;Leicht bewölkt;3;3;0
25.03.2020 21:00;42;23;19;Leicht bewölkt;2;2;0
25.03.2020 22:00;24;17;7;Leicht bewölkt;1;0;0
25.03.2020 23:00;13;6;7;Leicht bewölkt;0;-2;0
26.03.2020 00:00;13;8;5;Leicht bewölkt;-2;-4;0
26.03.2020 01:00;7;1;6;Leicht bewölkt;-2;-5;0
26.03.2020 02:00;5;2;3;Leicht bewölkt;-3;-6;0
26.03.2020 03:00;3;2;1;Leicht bewölkt;-4;-7;0
26.03.2020 04:00;8;6;2;Leicht bewölkt;-4;-7;0
26.03.2020 05:00;23;13;10;Leicht bewölkt;-4;-6;0
26.03.2020 06:00;108;71;37;Leicht bewölkt;-4;-6;0
26.03.2020 07:00;201;118;83;Leicht bewölkt;-2;-4;0
26.03.2020 08:00;221;138;83;Leicht bewölkt;0;-1;0
26.03.2020 09:00;180;102;78;Leicht bewölkt;2;1;0
26.03.2020 10:00;206;106;100;Leicht bewölkt;3;2;0
26.03.2020 11:00;227;121;106;Leicht bewölkt;5;3;0
26.03.2020 12:00;266;133;133;Leicht bewölkt;6;5;0
26.03.2020 13:00;242;107;135;Leicht bewölkt;7;5;0
26.03.2020 14:00;274;147;127;Leicht bewölkt;7;5;0
26.03.2020 15:00;287;128;159;Leicht bewölkt;7;5;0
26.03.2020 16:00;316;159;157;Leicht bewölkt;6;5;0
26.03.2020 17:00;352;146;206;Leicht bewölkt;6;4;0
26.03.2020 18:00;273;110;163;Leicht bewölkt;5;4;0
26.03.2020 19:00;137;59;78;Leicht bewölkt;3;3;0
26.03.2020 20:00;78;42;36;Leicht bewölkt;2;1;0
26.03.2020 21:00;46;24;22;Leicht bewölkt;1;0;0
26.03.2020 22:00;34;13;21;Leicht bewölkt;0;-1;0
26.03.2020 23:00;12;7;5;Leicht bewölkt;-1;-1;0
27.03.2020 00:00;8;6;2;Leicht bewölkt;-1;-2;0
27.03.2020 01:00;11;6;5;Leicht bewölkt;-2;-2;0
27.03.2020 02:00;10;6;4;Leicht bewölkt;-2;-3;0
27.03.2020 03:00;3;1;2;Leicht bewölkt;-3;-4;0
27.03.2020 04:00;10;7;3;Leicht bewölkt;-3;-3;0
27.03.2020 05:00;23;11;12;Leichter Nebel;-3;-3;0
27.03.2020 06:00;104;70;34;Leichter Nebel;-3;-3;0
27.03.2020 07:00;208;130;78;Leichter Nebel;0;-1;0
27.03.2020 08:00;237;170;67;Bewölkt;2;2;0
27.03.2020 09:00;250;123;127;Bewölkt;4;4;0
27.03.2020 10:00;270;148;122;Bewölkt;6;6;0
27.03.2020 11:00;324;155;169;Leicht bewölkt;8;8;0
27.03.2020 12:00;344;139;205;Leicht bewölkt;10;10;0
27.03.2020 13:00;338;132;206;Leicht bewölkt;11;11;0
27.03.2020 14:00;337;128;209;Leicht bewölkt;11;11;0
27.03.2020 15:00;353;163;190;Leicht bewölkt;12;12;0
27.03.2020 16:00;377;195;182;Leicht bewölkt;11;11;0
27.03.2020 17:00;355;183;172;Leicht bewölkt;10;10;0
27.03.2020 18:00;300;162;138;Leicht bewölkt;9;9;0
27.03.2020 19:00;180;97;83;Leicht bewölkt;8;8;0
27.03.2020 20:00;88;40;48;Leicht bewölkt;7;7;0
27.03.2020 21:00;51;30;21;Leicht bewölkt;6;6;0
27.03.2020 22:00;35;19;16;Leicht bewölkt;5;5;0
27.03.2020 23:00;26;13;13;Leicht bewölkt;4;4;0
28.03.2020 00:00;30;13;17;Leicht bewölkt;3;3;0
28.03.2020 01:00;12;6;6;Leicht bewölkt;2;2;0
28.03.2020 02:00;6;3;3;Leicht bewölkt;2;2;0
28.03.2020 03:00;5;2;3;Leicht bewölkt;2;2;0
28.03.2020 04:00;7;5;2;Leicht bewölkt;3;3;0
28.03.2020 05:00;17;10;7;Bewölkt;3;3;0
28.03.2020 06:00;23;11;12;Bewölkt;3;3;0
28.03.2020 07:00;44;19;25;Bewölkt;5;5;0
28.03.2020 08:00;83;46;37;Bewölkt;6;6;0
28.03.2020 09:00;155;74;81;Bewölkt;7;7;0
28.03.2020 10:00;226;99;127;Bewölkt;9;9;0
28.03.2020 11:00;289;123;166;Bewölkt;10;10;0
28.03.2020 12:00;371;152;219;Bewölkt;12;12;0
28.03.2020 13:00;343;126;217;Bewölkt;12;12;0
28.03.2020 14:00;427;162;265;Leicht bewölkt;13;13;0
28.03.2020 15:00;428;209;219;Leicht bewölkt;13;13;0
28.03.2020 16:00;417;235;182;Leicht bewölkt;13;13;0
28.03.2020 17:00;374;259;115;Leicht bewölkt;13;13;0
28.03.2020 18:00;298;184;114;Leicht bewölkt;12;12;0
28.03.2020 19:00;159;85;74;Leicht bewölkt;11;11;0
28.03.2020 20:00;95;50;45;Leicht bewölkt;10;10;0
28.03.2020 21:00;49;23;26;Leicht bewölkt;9;9;0
28.03.2020 22:00;39;22;17;Leicht bewölkt;8;8;0
28.03.2020 23:00;35;11;24;Leicht bewölkt;7;7;0
29.03.2020 00:00;13;5;8;Leicht bewölkt;7;6;1
29.03.2020 01:00;17;10;7;Leicht bewölkt;6;5;0
29.03.2020 03:00;;;;weather_condition_null;;;
29.03.2020 03:00;5;2;3;Stellenweiser Regenfall;4;3;0
29.03.2020 04:00;5;4;1;Stellenweiser Regenfall;4;3;0
29.03.2020 05:00;8;5;3;Leicht bewölkt;4;3;0
29.03.2020 06:00;17;8;9;Leicht bewölkt;5;3;0
29.03.2020 07:00;12;5;7;Leicht bewölkt;5;3;0
29.03.2020 08:00;12;5;7;Bedeckt;6;4;0
29.03.2020 09:00;42;23;19;Bedeckt;6;4;0
29.03.2020 10:00;57;31;26;Bedeckt;6;4;0
29.03.2020 11:00;90;40;50;Stellenweiser Regenfall;6;4;1
29.03.2020 12:00;83;33;50;Stellenweiser Regenfall;6;3;1
29.03.2020 13:00;86;47;39;Stellenweiser Regenfall;5;2;0
29.03.2020 14:00;83;36;47;Nieselregen;5;1;1
29.03.2020 15:00;52;27;25;Nieselregen;4;0;1
29.03.2020 16:00;49;25;24;Nieselregen;4;0;1
29.03.2020 17:00;64;31;33;Leichter Eisregen;3;-1;4
29.03.2020 18:00;58;28;30;Leichter Eisregen;3;-2;5
29.03.2020 19:00;59;31;28;Leichter Eisregen;2;-2;3
29.03.2020 20:00;45;19;26;Starker Schneefall;2;-2;9
29.03.2020 21:00;17;7;10;Starker Schneefall;2;-2;12
29.03.2020 22:00;15;11;4;Starker Schneefall;2;-3;6
29.03.2020 23:00;10;5;5;Starker Schneefall;2;-3;14
30.03.2020 00:00;7;7;0;Starker Schneefall;2;-4;28
30.03.2020 01:00;11;6;5;Starker Schneefall;1;-4;14
30.03.2020 02:00;2;1;1;Starker Schneefall;1;-4;5
30.03.2020 03:00;1;1;0;Starker Schneefall;1;-5;7
30.03.2020 04:00;8;5;3;Starker Schneefall;0;-5;4
30.03.2020 05:00;31;20;11;Mäßiger Schneefall;0;-6;0
30.03.2020 06:00;87;61;26;Mäßiger Schneefall;0;-6;0
30.03.2020 07:00;197;119;78;Mäßiger Schneefall;0;-6;0
30.03.2020 08:00;198;128;70;Mäßiger Schneefall;1;-5;0
30.03.2020 09:00;119;71;48;Mäßiger Schneefall;1;-5;0
30.03.2020 10:00;157;86;71;Mäßiger Schneefall;2;-3;0
30.03.2020 11:00;170;79;91;Leicht bewölkt;3;-2;0
30.03.2020 12:00;207;90;117;Leicht bewölkt;4;-1;0
30.03.2020 13:00;236;124;112;Leicht bewölkt;5;0;0
30.03.2020 14:00;228;91;137;Leicht bewölkt;5;1;0
30.03.2020 15:00;249;115;134;Leicht bewölkt;6;2;0
30.03.2020 16:00;309;130;179;Leicht bewölkt;5;2;0
30.03.2020 17:00;286;127;159;Leicht bewölkt;4;2;0
30.03.2020 18:00;250;114;136;Leicht bewölkt;3;2;0
30.03.2020 19:00;177;83;94;Leicht bewölkt;2;0;0
30.03.2020 20:00;99;47;52;Sonnig;0;-2;0
30.03.2020 21:00;60;28;32;Sonnig;-1;-4;0
30.03.2020 22:00;37;16;21;Sonnig;-2;-5;0
30.03.2020 23:00;21;12;9;Sonnig;-2;-6;0
31.03.2020 00:00;13;8;5;Sonnig;-3;-7;0
31.03.2020 01:00;16;5;11;Sonnig;-3;-7;0
31.03.2020 02:00;9;2;7;Sonnig;-3;-7;0
31.03.2020 03:00;4;2;2;Sonnig;-4;-7;0
31.03.2020 04:00;12;9;3;Sonnig;-3;-6;0
31.03.2020 05:00;29;14;15;Sonnig;-3;-5;0
31.03.2020 06:00;89;61;28;Sonnig;-2;-5;0
31.03.2020 07:00;219;131;88;Sonnig;-1;-3;0
31.03.2020 08:00;239;161;78;Leicht bewölkt;1;-2;0
31.03.2020 09:00;229;135;94;Leicht bewölkt;2;0;0
31.03.2020 10:00;228;108;120;Leicht bewölkt;4;1;0
31.03.2020 11:00;252;125;127;Leicht bewölkt;5;2;0
31.03.2020 12:00;295;134;161;Leicht bewölkt;7;4;0
31.03.2020 13:00;313;149;164;Leicht bewölkt;7;4;0
31.03.2020 14:00;333;140;193;Leicht bewölkt;7;5;0
31.03.2020 15:00;344;159;185;Leicht bewölkt;8;5;0
31.03.2020 16:00;431;210;221;Leicht bewölkt;7;5;0
31.03.2020 17:00;428;188;240;Leicht bewölkt;7;5;0
31.03.2020 18:00;334;155;179;Leicht bewölkt;6;5;0
31.03.2020 19:00;213;117;96;Leicht bewölkt;6;5;0
31.03.2020 20:00;108;41;67;Leicht bewölkt;5;5;0
31.03.2020 21:00;44;16;28;Leicht bewölkt;4;4;0
31.03.2020 22:00;44;20;24;Leicht bewölkt;3;2;0
31.03.2020 23:00;18;8;10;Leicht bewölkt;2;1;0
01.04.2020 00:00;19;5;14;Leicht bewölkt;0;-1;0
01.04.2020 01:00;16;11;5;Leicht bewölkt;0;-2;0
01.04.2020 02:00;10;6;4;Sonnig;-1;-3;0
01.04.2020 03:00;1;1;0;Sonnig;-2;-4;0
01.04.2020 04:00;8;5;3;Sonnig;-2;-3;0
01.04.2020 05:00;24;14;10;Sonnig;-1;-2;0
01.04.2020 06:00;108;68;40;Sonnig;-1;-2;0
01.04.2020 07:00;209;129;80;Sonnig;1;0;0
01.04.2020 08:00;238;154;84;Sonnig;2;2;0
01.04.2020 09:00;199;113;86;Sonnig;4;4;0
01.04.2020 10:00;197;89;108;Sonnig;6;5;0
01.04.2020 11:00;279;136;143;Leicht bewölkt;7;7;0
01.04.2020 12:00;297;138;159;Leicht bewölkt;9;9;0
01.04.2020 13:00;313;144;169;Leicht bewölkt;10;10;0
01.04.2020 14:00;340;154;186;Leicht bewölkt;11;11;0
01.04.2020 15:00;407;173;234;Leicht bewölkt;12;12;0
01.04.2020 16:00;435;202;233;Leicht bewölkt;12;12;0
01.04.2020 17:00;460;223;237;Leicht bewölkt;11;11;0
01.04.2020 18:00;367;166;201;Leicht bewölkt;11;11;0
01.04.2020 19:00;220;108;112;Leicht bewölkt;10;10;0
01.04.2020 20:00;111;55;56;Sonnig;8;8;0
01.04.2020 21:00;48;17;31;Sonnig;7;7;0
01.04.2020 22:00;35;22;13;Sonnig;5;5;0
01.04.2020 23:00;22;7;15;Sonnig;4;4;0
02.04.2020 00:00;13;4;9;Sonnig;2;2;0
02.04.2020 01:00;6;4;2;Sonnig;1;1;0
02.04.2020 02:00;5;2;3;Sonnig;0;0;0
02.04.2020 03:00;2;2;0;Sonnig;0;0;0
02.04.2020 04:00;8;6;2;Sonnig;0;0;0
02.04.2020 05:00;34;19;15;Sonnig;0;0;0
02.04.2020 06:00;97;62;35;Sonnig;1;1;0
02.04.2020 07:00;225;124;101;Sonnig;3;3;0
02.04.2020 08:00;252;173;79;Sonnig;5;5;0
02.04.2020 09:00;216;124;92;Sonnig;7;7;0
02.04.2020 10:00;238;129;109;Sonnig;9;9;0
02.04.2020 11:00;296;145;151;Sonnig;10;10;0
02.04.2020 12:00;308;118;190;Sonnig;12;12;0
02.04.2020 13:00;331;158;173;Sonnig;12;12;0
02.04.2020 14:00;412;172;240;Leicht bewölkt;12;12;0
02.04.2020 15:00;427;203;224;Leicht bewölkt;13;12;0
02.04.2020 16:00;461;208;253;Leicht bewölkt;12;12;0
02.04.2020 17:00;535;260;275;Leicht bewölkt;11;11;0
02.04.2020 18:00;410;200;210;Leicht bewölkt;11;10;0
02.04.2020 19:00;241;125;116;Leicht bewölkt;10;9;0
02.04.2020 20:00;132;62;70;Leicht bewölkt;9;9;0
02.04.2020 21:00;79;45;34;Leicht bewölkt;8;8;0
02.04.2020 22:00;39;20;19;Leicht bewölkt;6;6;0
02.04.2020 23:00;25;8;17;Leicht bewölkt;5;5;0
03.04.2020 00:00;22;10;12;Leicht bewölkt;3;3;0
03.04.2020 01:00;9;3;6;Leicht bewölkt;3;3;0
03.04.2020 02:00;7;2;5;Bedeckt;2;2;0
03.04.2020 03:00;6;5;1;Bedeckt;2;1;0
03.04.2020 04:00;8;6;2;Bedeckt;2;1;0
03.04.2020 05:00;24;14;10;Stellenweiser Regenfall;2;1;0
03.04.2020 06:00;103;68;35;Stellenweiser Regenfall;2;2;0
03.04.2020 07:00;195;127;68;Stellenweiser Regenfall;4;3;0
03.04.2020 08:00;264;176;88;Stellenweiser Regenfall;5;5;0
03.04.2020 09:00;224;127;97;Stellenweiser Regenfall;7;6;0
03.04.2020 10:00;291;152;139;Stellenweiser Regenfall;8;8;0
03.04.2020 11:00;307;150;157;Bewölkt;9;9;0
03.04.2020 12:00;369;145;224;Bewölkt;11;11;0
03.04.2020 13:00;331;144;187;Bewölkt;11;11;0
03.04.2020 14:00;387;171;216;Leicht bewölkt;11;11;0
03.04.2020 15:00;464;178;286;Leicht bewölkt;12;12;0
03.04.2020 16:00;440;214;226;Leicht bewölkt;11;11;0
03.04.2020 17:00;486;226;260;Leicht bewölkt;11;11;0
03.04.2020 18:00;360;188;172;Leicht bewölkt;11;10;0
03.04.2020 19:00;245;148;97;Leicht bewölkt;10;10;0
03.04.2020 20:00;144;79;65;Leicht bewölkt;9;9;0
03.04.2020 21:00;63;33;30;Leicht bewölkt;9;9;0
03.04.2020 22:00;48;27;21;Leicht bewölkt;7;7;0
03.04.2020 23:00;36;12;24;Leicht bewölkt;5;5;0
04.04.2020 00:00;17;5;12;Leicht bewölkt;3;3;0
04.04.2020 01:00;11;6;5;Leicht bewölkt;3;3;0
04.04.2020 02:00;10;5;5;Leicht bewölkt;2;2;0
04.04.2020 03:00;6;2;4;Leicht bewölkt;1;1;0
04.04.2020 04:00;4;3;1;Leicht bewölkt;1;1;0
04.04.2020 05:00;17;11;6;Leicht bewölkt;1;1;0
04.04.2020 06:00;24;19;5;Leicht bewölkt;2;2;0
04.04.2020 07:00;49;21;28;Leicht bewölkt;4;3;0
04.04.2020 08:00;91;54;37;Leicht bewölkt;6;5;0
04.04.2020 09:00;147;75;72;Leicht bewölkt;8;7;0
04.04.2020 10:00;216;86;130;Leicht bewölkt;9;9;0
04.04.2020 11:00;314;107;207;Leicht bewölkt;11;10;0
04.04.2020 12:00;333;154;179;Leicht bewölkt;13;12;0
04.04.2020 13:00;318;125;193;Leicht bewölkt;13;12;0
04.04.2020 14:00;458;193;265;Leicht bewölkt;13;13;0
04.04.2020 15:00;435;213;222;Leicht bewölkt;14;13;0
04.04.2020 16:00;434;225;209;Leicht bewölkt;13;13;0
04.04.2020 17:00;406;244;162;Leicht bewölkt;13;12;0
04.04.2020 18:00;341;213;128;Leicht bewölkt;12;12;0
04.04.2020 19:00;213;124;89;Leicht bewölkt;11;11;0
04.04.2020 20:00;163;87;76;Leicht bewölkt;10;10;0
04.04.2020 21:00;62;32;30;Leicht bewölkt;9;9;0
04.04.2020 22:00;31;13;18;Leicht bewölkt;8;8;0
04.04.2020 23:00;38;25;13;Sonnig;7;7;0
05.04.2020 00:00;20;8;12;Sonnig;6;6;0
05.04.2020 01:00;18;7;11;Sonnig;5;5;0
05.04.2020 02:00;5;1;4;Sonnig;5;5;0
05.04.2020 03:00;3;1;2;Sonnig;4;4;0
05.04.2020 04:00;4;4;0;Sonnig;4;4;0
05.04.2020 05:00;12;5;7;Leicht bewölkt;5;5;0
05.04.2020 06:00;20;12;8;Leicht bewölkt;5;5;0
05.04.2020 07:00;14;8;6;Leicht bewölkt;7;7;0
05.04.2020 08:00;41;17;24;Sonnig;9;9;0
05.04.2020 09:00;73;27;46;Sonnig;11;11;0
05.04.2020 10:00;165;70;95;Sonnig;13;13;0
05.04.2020 11:00;207;59;148;Sonnig;15;15;0
05.04.2020 12:00;275;108;167;Sonnig;16;16;0
05.04.2020 13:00;376;130;246;Sonnig;17;17;0
05.04.2020 14:00;425;185;240;Sonnig;17;17;0
05.04.2020 15:00;475;202;273;Sonnig;17;17;0
05.04.2020 16:00;430;258;172;Sonnig;17;17;0
05.04.2020 17:00;398;246;152;Leicht bewölkt;16;16;0
05.04.2020 18:00;331;208;123;Leicht bewölkt;16;16;0
05.04.2020 19:00;220;122;98;Leicht bewölkt;15;15;0
05.04.2020 20:00;173;101;72;Leicht bewölkt;14;14;0
05.04.2020 21:00;62;30;32;Leicht bewölkt;14;14;0
05.04.2020 22:00;31;15;16;Leicht bewölkt;12;12;0
05.04.2020 23:00;13;8;5;Leicht bewölkt;10;10;0
06.04.2020 00:00;14;11;3;Leicht bewölkt;8;8;0
06.04.2020 01:00;13;8;5;Leicht bewölkt;7;6;0
06.04.2020 02:00;6;1;5;Sonnig;6;5;0
06.04.2020 03:00;4;4;0;Sonnig;5;4;0
06.04.2020 04:00;7;5;2;Sonnig;5;4;0
06.04.2020 05:00;28;16;12;Sonnig;5;4;0
06.04.2020 06:00;121;80;41;Sonnig;5;4;0
06.04.2020 07:00;227;133;94;Sonnig;7;6;0
06.04.2020 08:00;278;180;98;Leicht bewölkt;9;9;0
06.04.2020 09:00;213;124;89;Leicht bewölkt;11;11;0
06.04.2020 10:00;233;124;109;Leicht bewölkt;13;13;0
06.04.2020 11:00;309;146;163;Leicht bewölkt;16;16;0
06.04.2020 12:00;365;154;211;Leicht bewölkt;18;18;0
06.04.2020 13:00;346;147;199;Leicht bewölkt;18;18;0
06.04.2020 14:00;447;212;235;Leicht bewölkt;19;19;0
06.04.2020 15:00;460;217;243;Leicht bewölkt;20;20;0
06.04.2020 16:00;516;244;272;Leicht bewölkt;19;19;0
06.04.2020 17:00;548;236;312;Leicht bewölkt;18;18;0
06.04.2020 18:00;412;187;225;Leicht bewölkt;18;18;0
06.04.2020 19:00;280;158;122;Leicht bewölkt;17;17;0
06.04.2020 20:00;160;82;78;Leicht bewölkt;16;16;0
06.04.2020 21:00;81;44;37;Leicht bewölkt;15;15;0
06.04.2020 22:00;46;22;24;Leicht bewölkt;13;13;0
06.04.2020 23:00;25;11;14;Leicht bewölkt;11;11;0
07.04.2020 00:00;17;11;6;Leicht bewölkt;9;9;0
07.04.2020 01:00;10;3;7;Leicht bewölkt;8;8;0
07.04.2020 02:00;2;1;1;Leicht bewölkt;7;7;0
07.04.2020 03:00;6;2;4;Leicht bewölkt;6;6;0
07.04.2020 04:00;10;9;1;Leicht bewölkt;6;6;0
07.04.2020 05:00;32;19;13;Leicht bewölkt;6;6;0
07.04.2020 06:00;117;70;47;Leicht bewölkt;6;6;0
07.04.2020 07:00;256;147;109;Leicht bewölkt;8;8;0
07.04.2020 08:00;268;177;91;Leicht bewölkt;10;10;0
07.04.2020 09:00;277;164;113;Leicht bewölkt;13;13;0
07.04.2020 10:00;330;162;168;Leicht bewölkt;14;14;0
07.04.2020 11:00;328;151;177;Leicht bewölkt;16;16;0
07.04.2020 12:00;339;178;161;Leicht bewölkt;18;18;0
07.04.2020 13:00;404;166;238;Leicht bewölkt;18;18;0
07.04.2020 14:00;421;194;227;Leicht bewölkt;18;18;0
07.04.2020 15:00;512;229;283;Leicht bewölkt;19;19;0
07.04.2020 16:00;556;239;317;Leicht bewölkt;18;18;0
07.04.2020 17:00;570;272;298;Leicht bewölkt;17;17;0
07.04.2020 18:00;449;223;226;Leicht bewölkt;16;16;0
07.04.2020 19:00;283;150;133;Leicht bewölkt;14;14;0
07.04.2020 20:00;162;92;70;Leicht bewölkt;13;13;0
07.04.2020 21:00;81;33;48;Leicht bewölkt;11;11;0
07.04.2020 22:00;53;24;29;Leicht bewölkt;10;10;0
07.04.2020 23:00;33;17;16;Leicht bewölkt;9;9;0
08.04.2020 00:00;24;11;13;Leicht bewölkt;8;8;0
08.04.2020 01:00;5;4;1;Leicht bewölkt;8;7;0
08.04.2020 02:00;4;1;3;Leicht bewölkt;7;7;0
08.04.2020 03:00;7;4;3;Leicht bewölkt;7;6;0
08.04.2020 04:00;11;6;5;Leicht bewölkt;7;7;0
08.04.2020 05:00;29;14;15;Leicht bewölkt;7;7;0
08.04.2020 06:00;113;71;42;Leicht bewölkt;8;7;0
08.04.2020 07:00;227;134;93;Leicht bewölkt;9;9;0
08.04.2020 08:00;276;176;100;Leicht bewölkt;11;11;0
08.04.2020 09:00;253;135;118;Leicht bewölkt;13;13;0
08.04.2020 10:00;293;129;164;Leicht bewölkt;15;15;0
08.04.2020 11:00;378;166;212;Leicht bewölkt;17;17;0
08.04.2020 12:00;372;162;210;Leicht bewölkt;19;19;0
08.04.2020 13:00;429;190;239;Leicht bewölkt;19;19;0
08.04.2020 14:00;405;183;222;Leicht bewölkt;20;20;0
08.04.2020 15:00;491;225;266;Leicht bewölkt;21;21;0
08.04.2020 16:00;568;255;313;Leicht bewölkt;20;20;0
08.04.2020 17:00;567;259;308;Leicht bewölkt;20;20;0
08.04.2020 18:00;455;220;235;Leicht bewölkt;20;20;0
08.04.2020 19:00;333;184;149;Leicht bewölkt;19;19;0
08.04.2020 20:00;181;97;84;Leicht bewölkt;18;18;0
08.04.2020 21:00;92;41;51;Leicht bewölkt;18;18;0
08.04.2020 22:00;68;36;32;Leicht bewölkt;15;15;0
08.04.2020 23:00;46;24;22;Leicht bewölkt;13;13;0
09.04.2020 00:00;24;12;12;Leicht bewölkt;11;11;0
09.04.2020 01:00;12;5;7;Leicht bewölkt;10;10;0
09.04.2020 02:00;4;2;2;Leicht bewölkt;8;8;0
09.04.2020 03:00;6;5;1;Leicht bewölkt;7;7;0
09.04.2020 04:00;7;5;2;Leicht bewölkt;7;7;0
09.04.2020 05:00;27;15;12;Leicht bewölkt;7;7;0
09.04.2020 06:00;117;78;39;Leicht bewölkt;8;8;0
09.04.2020 07:00;223;137;86;Leicht bewölkt;10;10;0
09.04.2020 08:00;284;185;99;Leicht bewölkt;12;12;0
09.04.2020 09:00;311;167;144;Leicht bewölkt;14;14;0
09.04.2020 10:00;329;166;163;Leicht bewölkt;16;16;0
09.04.2020 11:00;358;164;194;Leicht bewölkt;17;17;0
09.04.2020 12:00;435;192;243;Leicht bewölkt;18;18;0
09.04.2020 13:00;417;201;216;Leicht bewölkt;19;19;0
09.04.2020 14:00;438;185;253;Leicht bewölkt;19;19;0
09.04.2020 15:00;509;243;266;Leicht bewölkt;19;19;0
09.04.2020 16:00;581;249;332;Leicht bewölkt;19;19;0
09.04.2020 17:00;552;253;299;Leicht bewölkt;18;18;0
09.04.2020 18:00;465;238;227;Leicht bewölkt;18;18;0
09.04.2020 19:00;294;174;120;Leicht bewölkt;17;17;0
09.04.2020 20:00;193;84;109;Leicht bewölkt;16;16;0
09.04.2020 21:00;83;38;45;Leicht bewölkt;15;15;0
09.04.2020 22:00;53;28;25;Leicht bewölkt;13;13;0
09.04.2020 23:00;39;21;18;Leicht bewölkt;12;11;0
10.04.2020 00:00;25;11;14;Leicht bewölkt;10;10;0
10.04.2020 01:00;16;11;5;Leicht bewölkt;9;9;0
10.04.2020 02:00;9;6;3;Leicht bewölkt;8;8;0
10.04.2020 03:00;4;3;1;Leicht bewölkt;7;7;0
10.04.2020 04:00;4;2;2;Leicht bewölkt;8;8;0
10.04.2020 05:00;10;2;8;Leicht bewölkt;8;8;0
10.04.2020 06:00;20;11;9;Leicht bewölkt;9;9;0
10.04.2020 07:00;37;16;21;Leicht bewölkt;11;11;0
10.04.2020 08:00;51;26;25;Leicht bewölkt;13;13;0
10.04.2020 09:00;99;44;55;Leicht bewölkt;15;15;0
10.04.2020 10:00;159;50;109;Leicht bewölkt;16;16;0
10.04.2020 11:00;267;102;165;Leicht bewölkt;18;18;0
10.04.2020 12:00;307;134;173;Leicht bewölkt;19;19;0
10.04.2020 13:00;362;110;252;Leicht bewölkt;19;19;0
10.04.2020 14:00;432;191;241;Leicht bewölkt;19;19;0
10.04.2020 15:00;410;197;213;Leicht bewölkt;20;20;0
10.04.2020 16:00;453;248;205;Leicht bewölkt;19;19;0
10.04.2020 17:00;415;229;186;Leicht bewölkt;19;19;0
10.04.2020 18:00;358;226;132;Leicht bewölkt;18;18;0
10.04.2020 19:00;276;161;115;Leicht bewölkt;17;17;0
10.04.2020 20:00;188;99;89;Leicht bewölkt;16;16;0
10.04.2020 21:00;86;44;42;Leicht bewölkt;15;15;0
10.04.2020 22:00;49;18;31;Leicht bewölkt;13;13;0
10.04.2020 23:00;39;19;20;Leicht bewölkt;11;11;0
11.04.2020 00:00;24;8;16;Leicht bewölkt;10;10;0
11.04.2020 01:00;26;16;10;Leicht bewölkt;9;9;0
11.04.2020 02:00;6;4;2;Leicht bewölkt;8;8;0
11.04.2020 03:00;5;2;3;Leicht bewölkt;7;7;0
11.04.2020 04:00;5;5;0;Leicht bewölkt;8;8;0
11.04.2020 05:00;21;10;11;Leicht bewölkt;8;8;0
11.04.2020 06:00;40;24;16;Leicht bewölkt;9;9;0
11.04.2020 07:00;81;24;57;Leicht bewölkt;10;10;0
11.04.2020 08:00;159;75;84;Leicht bewölkt;12;12;0
11.04.2020 09:00;260;106;154;Leicht bewölkt;14;14;0
11.04.2020 10:00;422;183;239;Leicht bewölkt;16;16;0
11.04.2020 11:00;482;228;254;Leicht bewölkt;17;17;0
11.04.2020 12:00;366;190;176;Leicht bewölkt;19;19;0
11.04.2020 13:00;404;186;218;Leicht bewölkt;19;19;0
11.04.2020 14:00;438;177;261;Leicht bewölkt;19;19;0
11.04.2020 15:00;444;220;224;Leicht bewölkt;19;19;0
11.04.2020 16:00;464;229;235;Leicht bewölkt;19;19;0
11.04.2020 17:00;472;288;184;Leicht bewölkt;18;18;0
11.04.2020 18:00;428;242;186;Leicht bewölkt;18;18;0
11.04.2020 19:00;327;175;152;Leicht bewölkt;17;17;0
11.04.2020 20:00;244;109;135;Leicht bewölkt;17;17;0
11.04.2020 21:00;126;69;57;Leicht bewölkt;16;16;0
11.04.2020 22:00;62;36;26;Leicht bewölkt;14;14;0
11.04.2020 23:00;52;19;33;Leicht bewölkt;12;12;0
12.04.2020 00:00;32;13;19;Leicht bewölkt;11;11;0
12.04.2020 01:00;11;6;5;Leicht bewölkt;10;10;0
12.04.2020 02:00;4;3;1;Leicht bewölkt;9;9;0
12.04.2020 03:00;2;1;1;Leicht bewölkt;8;8;0
12.04.2020 04:00;3;3;0;Leicht bewölkt;8;8;0
12.04.2020 05:00;8;5;3;Leicht bewölkt;8;8;0
12.04.2020 06:00;36;27;9;Leicht bewölkt;8;8;0
12.04.2020 07:00;37;14;23;Leicht bewölkt;10;10;0
12.04.2020 08:00;48;18;30;Leicht bewölkt;12;12;0
12.04.2020 09:00;112;37;75;Leicht bewölkt;14;14;0
12.04.2020 10:00;185;73;112;Leicht bewölkt;16;16;0
12.04.2020 11:00;233;84;149;Leicht bewölkt;18;18;0
12.04.2020 12:00;283;94;189;Leicht bewölkt;20;20;0
12.04.2020 13:00;350;112;238;Leicht bewölkt;20;20;0
12.04.2020 14:00;393;141;252;Leicht bewölkt;20;20;2
12.04.2020 15:00;386;186;200;Leicht bewölkt;20;20;3
12.04.2020 16:00;349;184;165;Leicht bewölkt;19;19;1
12.04.2020 17:00;428;265;163;Nieselregen mit Gewitter;18;18;6
12.04.2020 18:00;319;193;126;Nieselregen mit Gewitter;17;17;8
12.04.2020 19:00;231;129;102;Nieselregen mit Gewitter;16;16;4
12.04.2020 20:00;148;90;58;Stellenweiser Regenfall;15;15;3
12.04.2020 21:00;78;47;31;Stellenweiser Regenfall;13;13;4
12.04.2020 22:00;56;30;26;Stellenweiser Regenfall;12;12;2
12.04.2020 23:00;30;17;13;Bedeckt;11;11;0
13.04.2020 00:00;27;14;13;Bedeckt;10;9;0
13.04.2020 01:00;17;12;5;Bedeckt;9;9;0
13.04.2020 02:00;8;6;2;Bedeckt;9;8;3
13.04.2020 03:00;17;7;10;Bedeckt;8;7;4
13.04.2020 04:00;6;5;1;Bedeckt;8;8;2
13.04.2020 05:00;10;3;7;Leichter Regenschauer;9;8;4
13.04.2020 06:00;32;19;13;Leichter Regenschauer;9;8;5
13.04.2020 07:00;26;11;15;Leichter Regenschauer;10;10;2
13.04.2020 08:00;52;28;24;Leichter Regenschauer;12;12;1
13.04.2020 09:00;97;39;58;Leichter Regenschauer;14;13;1
13.04.2020 10:00;202;82;120;Leichter Regenschauer;15;15;1
13.04.2020 11:00;277;105;172;Bedeckt;17;16;0
13.04.2020 12:00;291;112;179;Bedeckt;18;18;0
13.04.2020 13:00;363;147;216;Bedeckt;18;18;0
13.04.2020 14:00;414;204;210;Leicht bewölkt;18;18;1
13.04.2020 15:00;361;206;155;Leicht bewölkt;17;17;1
13.04.2020 16:00;338;184;154;Leicht bewölkt;17;17;0
13.04.2020 17:00;361;192;169;Stellenweiser Regenfall;16;16;6
13.04.2020 18:00;288;162;126;Stellenweiser Regenfall;15;15;8
13.04.2020 19:00;170;92;78;Stellenweiser Regenfall;14;14;4
13.04.2020 20:00;104;56;48;Leichter Regenschauer;13;13;4
13.04.2020 21:00;40;16;24;Leichter Regenschauer;12;12;6
13.04.2020 22:00;36;16;20;Leichter Regenschauer;9;9;3
13.04.2020 23:00;21;8;13;Stellenweiser Regenfall;7;6;3
14.04.2020 00:00;13;8;5;Stellenweiser Regenfall;5;3;5
14.04.2020 01:00;9;7;2;Stellenweiser Regenfall;3;1;3
14.04.2020 02:00;7;5;2;Teilweise mäßiger Regenfall;2;-1;1
14.04.2020 03:00;4;3;1;Teilweise mäßiger Regenfall;1;-3;1
14.04.2020 04:00;8;6;2;Teilweise mäßiger Regenfall;1;-3;1
14.04.2020 05:00;27;19;8;Sonnig;1;-3;0
14.04.2020 06:00;108;79;29;Sonnig;1;-3;0
14.04.2020 07:00;225;138;87;Sonnig;2;-1;0
14.04.2020 08:00;254;172;82;Sonnig;4;0;0
14.04.2020 09:00;235;134;101;Sonnig;5;2;0
14.04.2020 10:00;286;146;140;Sonnig;6;4;0
14.04.2020 11:00;315;158;157;Leicht bewölkt;7;5;0
14.04.2020 12:00;303;128;175;Leicht bewölkt;8;6;0
14.04.2020 13:00;378;173;205;Leicht bewölkt;9;7;0
14.04.2020 14:00;331;139;192;Leicht bewölkt;9;7;0
14.04.2020 15:00;368;168;200;Leicht bewölkt;9;7;0
14.04.2020 16:00;445;206;239;Leicht bewölkt;8;7;0
14.04.2020 17:00;506;253;253;Leicht bewölkt;7;6;0
14.04.2020 18:00;365;167;198;Leicht bewölkt;7;6;0
14.04.2020 19:00;240;127;113;Leicht bewölkt;5;4;0
14.04.2020 20:00;141;68;73;Leicht bewölkt;4;2;0
14.04.2020 21:00;58;36;22;Leicht bewölkt;2;0;0
14.04.2020 22:00;40;14;26;Leicht bewölkt;2;-1;0
14.04.2020 23:00;30;14;16;Sonnig;1;-1;0
15.04.2020 00:00;18;8;10;Sonnig;1;-2;0
15.04.2020 01:00;9;1;8;Sonnig;0;-2;0
15.04.2020 02:00;6;3;3;Sonnig;0;-2;0
15.04.2020 03:00;3;2;1;Sonnig;0;-3;0
15.04.2020 04:00;11;8;3;Sonnig;1;-1;0
15.04.2020 05:00;26;19;7;Sonnig;1;0;0
15.04.2020 06:00;119;84;35;Sonnig;2;1;0
15.04.2020 07:00;214;138;76;Sonnig;5;4;0
15.04.2020 08:00;277;178;99;Leicht bewölkt;7;7;0
15.04.2020 09:00;237;133;104;Leicht bewölkt;10;9;0
15.04.2020 10:00;293;144;149;Leicht bewölkt;11;11;0
15.04.2020 11:00;308;139;169;Leicht bewölkt;13;13;0
15.04.2020 12:00;380;165;215;Leicht bewölkt;14;14;0
15.04.2020 13:00;431;186;245;Leicht bewölkt;15;15;0
15.04.2020 14:00;403;187;216;Leicht bewölkt;15;15;0
15.04.2020 15:00;505;227;278;Leicht bewölkt;16;16;0
15.04.2020 16:00;527;226;301;Leicht bewölkt;15;15;0
15.04.2020 17:00;556;267;289;Leicht bewölkt;15;15;0
15.04.2020 18:00;480;230;250;Leicht bewölkt;14;14;0
15.04.2020 19:00;295;139;156;Leicht bewölkt;13;13;0
15.04.2020 20:00;203;96;107;Leicht bewölkt;12;12;0
15.04.2020 21:00;102;41;61;Leicht bewölkt;11;11;0
15.04.2020 22:00;40;15;25;Leicht bewölkt;9;9;0
15.04.2020 23:00;45;23;22;Leicht bewölkt;8;8;0
16.04.2020 00:00;19;8;11;Leicht bewölkt;6;6;0
16.04.2020 01:00;11;6;5;Leicht bewölkt;5;5;0
16.04.2020 02:00;6;2;4;Leicht bewölkt;4;4;0
16.04.2020 03:00;4;4;0;Leicht bewölkt;3;3;0
16.04.2020 04:00;12;9;3;Leicht bewölkt;4;4;0
16.04.2020 05:00;29;19;10;Leicht bewölkt;5;5;0
16.04.2020 06:00;99;70;29;Leicht bewölkt;6;7;0
16.04.2020 07:00;237;139;98;Leicht bewölkt;8;9;0
16.04.2020 08:00;267;176;91;Sonnig;10;11;0
16.04.2020 09:00;249;139;110;Sonnig;12;13;0
16.04.2020 10:00;290;134;156;Sonnig;14;14;0
16.04.2020 11:00;349;163;186;Bedeckt;16;16;0
16.04.2020 12:00;393;168;225;Bedeckt;18;18;0
16.04.2020 13:00;406;199;207;Bedeckt;19;19;0
16.04.2020 14:00;426;215;211;Leicht bewölkt;20;20;0
16.04.2020 15:00;499;219;280;Leicht bewölkt;21;21;0
16.04.2020 16:00;601;255;346;Leicht bewölkt;21;21;0
16.04.2020 17:00;587;280;307;Leicht bewölkt;21;21;0
16.04.2020 18:00;480;230;250;Leicht bewölkt;20;20;0
16.04.2020 19:00;376;206;170;Leicht bewölkt;19;19;0
16.04.2020 20:00;241;109;132;Leicht bewölkt;18;18;0
16.04.2020 21:00;121;63;58;Leicht bewölkt;17;17;0
16.04.2020 22:00;71;35;36;Leicht bewölkt;15;15;0
16.04.2020 23:00;40;20;20;Leicht bewölkt;13;13;0
17.04.2020 00:00;21;8;13;Leicht bewölkt;11;11;0
17.04.2020 01:00;13;6;7;Leicht bewölkt;9;10;0
17.04.2020 02:00;6;4;2;Leicht bewölkt;8;8;0
17.04.2020 03:00;6;6;0;Leicht bewölkt;7;7;0
17.04.2020 04:00;10;8;2;Leicht bewölkt;8;7;0
17.04.2020 05:00;24;16;8;Leicht bewölkt;8;8;0
17.04.2020 06:00;122;81;41;Leicht bewölkt;8;8;0
17.04.2020 07:00;241;144;97;Leicht bewölkt;10;10;0
17.04.2020 08:00;256;165;91;Leicht bewölkt;12;12;0
17.04.2020 09:00;284;169;115;Leicht bewölkt;14;14;0
17.04.2020 10:00;379;178;201;Leicht bewölkt;16;16;0
17.04.2020 11:00;391;200;191;Leicht bewölkt;18;18;0
17.04.2020 12:00;442;196;246;Leicht bewölkt;20;20;0
17.04.2020 13:00;474;201;273;Leicht bewölkt;21;21;0
17.04.2020 14:00;462;184;278;Leicht bewölkt;22;22;0
17.04.2020 15:00;546;233;313;Leicht bewölkt;22;24;0
17.04.2020 16:00;563;255;308;Leicht bewölkt;22;22;0
17.04.2020 17:00;589;284;305;Leicht bewölkt;21;21;0
17.04.2020 18:00;581;302;279;Leicht bewölkt;21;21;0
17.04.2020 19:00;342;190;152;Leicht bewölkt;20;20;0
17.04.2020 20:00;245;111;134;Leicht bewölkt;19;19;0
17.04.2020 21:00;131;70;61;Leicht bewölkt;18;18;0
17.04.2020 22:00;87;40;47;Leicht bewölkt;16;16;0
17.04.2020 23:00;60;35;25;Stellenweiser Regenfall;14;14;0
18.04.2020 00:00;35;18;17;Stellenweiser Regenfall;13;13;1
18.04.2020 01:00;20;10;10;Stellenweiser Regenfall;12;12;0
18.04.2020 02:00;9;4;5;Stellenweiser Regenfall;11;11;0
18.04.2020 03:00;6;4;2;Stellenweiser Regenfall;10;10;0
18.04.2020 04:00;8;6;2;Stellenweiser Regenfall;10;10;0
18.04.2020 05:00;11;6;5;Bedeckt;10;11;0
18.04.2020 06:00;40;23;17;Bedeckt;11;11;0
18.04.2020 07:00;65;27;38;Bedeckt;12;12;0
18.04.2020 08:00;116;53;63;Stellenweise Gewitter und Niederschläge;14;14;1
18.04.2020 09:00;209;90;119;Stellenweise Gewitter und Niederschläge;15;15;2
18.04.2020 10:00;323;139;184;Stellenweise Gewitter und Niederschläge;16;16;1
18.04.2020 11:00;412;181;231;Leichter Regenschauer;18;18;1
18.04.2020 12:00;455;213;242;Leichter Regenschauer;19;19;1
18.04.2020 13:00;434;178;256;Leichter Regenschauer;19;19;0
18.04.2020 14:00;443;189;254;Leicht bewölkt;20;20;2
18.04.2020 15:00;485;223;262;Leicht bewölkt;20;20;3
18.04.2020 16:00;543;291;252;Leicht bewölkt;20;20;2
18.04.2020 17:00;511;326;185;Stellenweiser Regenfall;19;19;1
18.04.2020 18:00;391;199;192;Stellenweiser Regenfall;18;18;1
18.04.2020 19:00;312;172;140;Stellenweiser Regenfall;16;16;1
18.04.2020 20:00;230;123;107;Stellenweise Gewitter und Niederschläge;15;15;2
18.04.2020 21:00;137;78;59;Stellenweise Gewitter und Niederschläge;13;14;3
18.04.2020 22:00;63;29;34;Stellenweise Gewitter und Niederschläge;13;13;2
18.04.2020 23:00;69;38;31;Leichter Regenschauer;12;12;4
19.04.2020 00:00;29;16;13;Leichter Regenschauer;11;11;7
19.04.2020 01:00;29;17;12;Leichter Regenschauer;10;11;4
19.04.2020 02:00;10;6;4;Stellenweiser Regenfall;10;10;1
19.04.2020 03:00;13;6;7;Stellenweiser Regenfall;10;10;2
19.04.2020 04:00;2;2;0;Stellenweiser Regenfall;10;10;1
19.04.2020 05:00;13;10;3;Leicht bewölkt;11;11;0
19.04.2020 06:00;28;14;14;Leicht bewölkt;11;11;0
19.04.2020 07:00;20;14;6;Leicht bewölkt;13;13;0
19.04.2020 08:00;50;21;29;Leicht bewölkt;14;14;0
19.04.2020 09:00;113;47;66;Leicht bewölkt;16;16;0
19.04.2020 10:00;190;60;130;Leicht bewölkt;17;17;0
19.04.2020 11:00;278;95;183;Leicht bewölkt;18;18;0
19.04.2020 12:00;358;148;210;Leicht bewölkt;19;19;0
19.04.2020 13:00;454;206;248;Leicht bewölkt;19;19;0
19.04.2020 14:00;474;231;243;Leicht bewölkt;19;19;0
19.04.2020 15:00;499;230;269;Leicht bewölkt;19;19;0
19.04.2020 16:00;467;247;220;Leicht bewölkt;18;18;0
19.04.2020 17:00;435;246;189;Leicht bewölkt;17;16;0
19.04.2020 18:00;472;279;193;Leicht bewölkt;16;15;0
19.04.2020 19:00;285;166;119;Leicht bewölkt;15;13;0
19.04.2020 20:00;179;95;84;Leicht bewölkt;14;12;0
19.04.2020 21:00;103;53;50;Leicht bewölkt;12;10;0
19.04.2020 22:00;51;23;28;Leicht bewölkt;12;10;0
19.04.2020 23:00;35;20;15;Leicht bewölkt;11;9;0
20.04.2020 00:00;19;12;7;Leicht bewölkt;11;9;0
20.04.2020 01:00;8;4;4;Leicht bewölkt;11;8;0
20.04.2020 02:00;3;3;0;Leicht bewölkt;10;8;1
20.04.2020 03:00;1;0;1;Leicht bewölkt;10;7;1
20.04.2020 04:00;10;9;1;Leicht bewölkt;10;7;0
20.04.2020 05:00;26;15;11;Leichter Regenschauer;10;7;1
20.04.2020 06:00;144;101;43;Leichter Regenschauer;10;7;2
20.04.2020 07:00;294;187;107;Leichter Regenschauer;10;8;1
20.04.2020 08:00;302;208;94;Leichter Regenschauer;11;9;0
20.04.2020 09:00;320;189;131;Leichter Regenschauer;11;9;0
20.04.2020 10:00;315;172;143;Leichter Regenschauer;12;11;0
20.04.2020 11:00;366;182;184;Leicht bewölkt;13;12;0
20.04.2020 12:00;395;178;217;Leicht bewölkt;15;14;0
20.04.2020 13:00;463;235;228;Leicht bewölkt;15;15;0
20.04.2020 14:00;515;220;295;Leicht bewölkt;16;16;0
20.04.2020 15:00;522;225;297;Leicht bewölkt;17;17;0
20.04.2020 16:00;599;252;347;Leicht bewölkt;16;16;0
20.04.2020 17:00;576;253;323;Leicht bewölkt;15;15;0
20.04.2020 18:00;496;203;293;Leicht bewölkt;15;14;0
20.04.2020 19:00;347;172;175;Leicht bewölkt;14;12;0
20.04.2020 20:00;194;98;96;Leicht bewölkt;13;11;0
20.04.2020 21:00;126;58;68;Leicht bewölkt;12;10;0
20.04.2020 22:00;56;24;32;Leicht bewölkt;11;9;0
20.04.2020 23:00;26;11;15;Leicht bewölkt;10;8;0
21.04.2020 00:00;24;13;11;Leicht bewölkt;9;7;0
21.04.2020 01:00;19;11;8;Leicht bewölkt;9;7;0
21.04.2020 02:00;3;3;0;Leicht bewölkt;8;6;0
21.04.2020 03:00;2;2;0;Leicht bewölkt;8;6;0
21.04.2020 04:00;12;9;3;Leicht bewölkt;8;6;0
21.04.2020 05:00;34;20;14;Leicht bewölkt;8;6;0
21.04.2020 06:00;152;97;55;Leicht bewölkt;8;6;0
21.04.2020 07:00;305;192;113;Leicht bewölkt;9;7;0
21.04.2020 08:00;358;237;121;Leicht bewölkt;10;9;0
21.04.2020 09:00;305;190;115;Leicht bewölkt;12;10;0
21.04.2020 10:00;333;184;149;Leicht bewölkt;13;12;0
21.04.2020 11:00;368;184;184;Leicht bewölkt;15;14;0
21.04.2020 12:00;402;177;225;Leicht bewölkt;16;16;0
21.04.2020 13:00;454;225;229;Leicht bewölkt;17;17;0
21.04.2020 14:00;482;234;248;Leicht bewölkt;17;17;0
21.04.2020 15:00;589;278;311;Leicht bewölkt;18;18;0
21.04.2020 16:00;621;279;342;Leicht bewölkt;18;18;0
21.04.2020 17:00;668;270;398;Leicht bewölkt;17;17;0
21.04.2020 18:00;539;224;315;Leicht bewölkt;17;17;0
21.04.2020 19:00;327;158;169;Leicht bewölkt;16;16;0
21.04.2020 20:00;197;87;110;Leicht bewölkt;15;15;0
21.04.2020 21:00;127;61;66;Leicht bewölkt;13;13;0
21.04.2020 22:00;74;36;38;Leicht bewölkt;12;12;0
21.04.2020 23:00;45;18;27;Leicht bewölkt;10;10;0
22.04.2020 00:00;28;15;13;Leicht bewölkt;9;8;0
22.04.2020 01:00;12;5;7;Leicht bewölkt;8;7;0
22.04.2020 02:00;5;4;1;Leicht bewölkt;7;6;0
22.04.2020 03:00;3;1;2;Leicht bewölkt;6;4;0
22.04.2020 04:00;14;9;5;Leicht bewölkt;6;5;0
22.04.2020 05:00;35;16;19;Leicht bewölkt;6;5;0
22.04.2020 06:00;156;106;50;Leicht bewölkt;7;6;0
22.04.2020 07:00;279;168;111;Leicht bewölkt;8;8;0
22.04.2020 08:00;353;247;106;Leicht bewölkt;10;10;0
22.04.2020 09:00;316;184;132;Leicht bewölkt;12;12;0
22.04.2020 10:00;306;156;150;Leicht bewölkt;13;13;0
22.04.2020 11:00;416;206;210;Leicht bewölkt;15;15;0
22.04.2020 12:00;498;221;277;Leicht bewölkt;16;16;0
22.04.2020 13:00;477;252;225;Leicht bewölkt;17;17;0
22.04.2020 14:00;535;230;305;Leicht bewölkt;17;17;0
22.04.2020 15:00;541;242;299;Leicht bewölkt;18;18;0
22.04.2020 16:00;803;356;447;Leicht bewölkt;17;17;0
22.04.2020 17:00;728;321;407;Leicht bewölkt;17;17;0
22.04.2020 18:00;648;272;376;Leicht bewölkt;16;16;0
22.04.2020 19:00;418;195;223;Leicht bewölkt;15;15;0
22.04.2020 20:00;320;165;155;Leicht bewölkt;15;15;0
22.04.2020 21:00;164;92;72;Leicht bewölkt;14;14;0
22.04.2020 22:00;90;45;45;Leicht bewölkt;12;12;0
22.04.2020 23:00;54;25;29;Leicht bewölkt;11;10;0
23.04.2020 00:00;21;8;13;Leicht bewölkt;9;8;0
23.04.2020 01:00;9;4;5;Leicht bewölkt;8;7;0
23.04.2020 02:00;7;5;2;Leicht bewölkt;7;6;0
23.04.2020 03:00;0;0;0;Leicht bewölkt;5;5;0
23.04.2020 04:00;9;6;3;Leicht bewölkt;6;5;0
23.04.2020 05:00;35;20;15;Leicht bewölkt;6;6;0
23.04.2020 06:00;138;88;50;Leicht bewölkt;7;6;0
23.04.2020 07:00;286;175;111;Leicht bewölkt;8;8;0
23.04.2020 08:00;363;233;130;Leicht bewölkt;10;10;0
23.04.2020 09:00;304;175;129;Leicht bewölkt;12;12;0
23.04.2020 10:00;309;157;152;Leicht bewölkt;13;14;0
23.04.2020 11:00;411;190;221;Leicht bewölkt;15;15;0
23.04.2020 12:00;519;256;263;Leicht bewölkt;17;17;0
23.04.2020 13:00;525;246;279;Leicht bewölkt;18;18;0
23.04.2020 14:00;516;244;272;Sonnig;19;19;0
23.04.2020 15:00;562;270;292;Sonnig;20;20;0
23.04.2020 16:00;752;351;401;Sonnig;19;19;0
23.04.2020 17:00;771;341;430;Sonnig;18;18;0
23.04.2020 18:00;623;255;368;Sonnig;18;18;0
23.04.2020 19:00;455;219;236;Sonnig;17;17;0
23.04.2020 20:00;293;136;157;Sonnig;16;16;0
23.04.2020 21:00;205;100;105;Sonnig;15;15;0
23.04.2020 22:00;80;41;39;Sonnig;13;13;0
23.04.2020 23:00;47;20;27;Sonnig;12;12;0
24.04.2020 00:00;36;15;21;Sonnig;10;10;0
24.04.2020 01:00;16;11;5;Sonnig;9;9;0
24.04.2020 02:00;4;2;2;Leicht bewölkt;8;8;0
24.04.2020 03:00;3;2;1;Leicht bewölkt;8;8;0
24.04.2020 04:00;12;9;3;Leicht bewölkt;8;8;0
24.04.2020 05:00;26;15;11;Leicht bewölkt;9;9;0
24.04.2020 06:00;129;82;47;Leicht bewölkt;9;9;0
24.04.2020 07:00;273;179;94;Leicht bewölkt;11;11;0
24.04.2020 08:00;364;234;130;Leicht bewölkt;13;13;0
24.04.2020 09:00;354;210;144;Leicht bewölkt;14;15;0
24.04.2020 10:00;483;252;231;Leicht bewölkt;16;16;0
24.04.2020 11:00;511;233;278;Leicht bewölkt;17;17;0
24.04.2020 12:00;534;233;301;Leicht bewölkt;19;19;0
24.04.2020 13:00;531;241;290;Leicht bewölkt;19;19;0
24.04.2020 14:00;578;280;298;Leicht bewölkt;19;19;0
24.04.2020 15:00;591;275;316;Leicht bewölkt;20;20;0
24.04.2020 16:00;653;286;367;Leicht bewölkt;19;19;0
24.04.2020 17:00;643;310;333;Leicht bewölkt;19;19;0
24.04.2020 18:00;544;241;303;Leicht bewölkt;19;19;0
24.04.2020 19:00;348;156;192;Leicht bewölkt;18;18;0
24.04.2020 20:00;281;136;145;Leicht bewölkt;17;17;0
24.04.2020 21:00;154;81;73;Leicht bewölkt;17;17;0
24.04.2020 22:00;107;35;72;Leicht bewölkt;15;15;0
24.04.2020 23:00;84;36;48;Leicht bewölkt;13;13;0
25.04.2020 00:00;55;36;19;Leicht bewölkt;12;12;0
25.04.2020 01:00;41;26;15;Leicht bewölkt;11;11;0
25.04.2020 02:00;8;2;6;Leicht bewölkt;9;9;2
25.04.2020 03:00;3;0;3;Leicht bewölkt;8;8;3
25.04.2020 04:00;6;3;3;Leicht bewölkt;9;9;1
25.04.2020 05:00;16;7;9;Leichter Regenschauer;10;10;4
25.04.2020 06:00;42;27;15;Leichter Regenschauer;10;10;5
25.04.2020 07:00;66;30;36;Leichter Regenschauer;12;12;3
25.04.2020 08:00;128;65;63;Leichter Regenschauer;14;14;2
25.04.2020 09:00;232;127;105;Leichter Regenschauer;16;16;3
25.04.2020 10:00;331;162;169;Leichter Regenschauer;17;17;2
25.04.2020 11:00;463;232;231;Stellenweiser Regenfall;17;17;2
25.04.2020 12:00;518;257;261;Stellenweiser Regenfall;18;18;3
25.04.2020 13:00;476;214;262;Stellenweiser Regenfall;18;18;1
25.04.2020 14:00;543;253;290;Stellenweiser Regenfall;19;19;1
25.04.2020 15:00;614;271;343;Stellenweiser Regenfall;19;19;2
25.04.2020 16:00;562;255;307;Stellenweiser Regenfall;18;18;1
25.04.2020 17:00;564;307;257;Stellenweiser Regenfall;17;17;1
25.04.2020 18:00;398;214;184;Stellenweiser Regenfall;17;17;2
25.04.2020 19:00;349;183;166;Stellenweiser Regenfall;16;16;1
25.04.2020 20:00;250;133;117;Stellenweiser Regenfall;15;15;1
25.04.2020 21:00;152;70;82;Stellenweiser Regenfall;14;14;1
25.04.2020 22:00;92;52;40;Stellenweiser Regenfall;12;12;0
25.04.2020 23:00;87;43;44;Leicht bewölkt;10;10;0
26.04.2020 00:00;57;30;27;Leicht bewölkt;9;8;0
26.04.2020 01:00;43;18;25;Leicht bewölkt;7;7;0
26.04.2020 02:00;32;14;18;Leicht bewölkt;6;6;0
26.04.2020 03:00;10;6;4;Leicht bewölkt;5;5;0
26.04.2020 04:00;10;2;8;Leicht bewölkt;6;6;0
26.04.2020 05:00;21;10;11;Leicht bewölkt;7;7;0
26.04.2020 06:00;25;17;8;Leicht bewölkt;8;8;0
26.04.2020 07:00;44;22;22;Leicht bewölkt;10;10;0
26.04.2020 08:00;62;28;34;Leicht bewölkt;12;12;0
26.04.2020 09:00;91;40;51;Leicht bewölkt;14;14;0
26.04.2020 10:00;170;64;106;Leicht bewölkt;15;15;0
26.04.2020 11:00;245;117;128;Leicht bewölkt;17;17;0
26.04.2020 12:00;283;125;158;Leicht bewölkt;18;18;0
26.04.2020 13:00;370;139;231;Leicht bewölkt;18;18;0
26.04.2020 14:00;434;167;267;Stellenweiser Regenfall;18;18;0
26.04.2020 15:00;459;231;228;Stellenweiser Regenfall;19;19;0
26.04.2020 16:00;464;248;216;Stellenweiser Regenfall;18;18;0
26.04.2020 17:00;480;254;226;Stellenweiser Regenfall;17;17;1
26.04.2020 18:00;421;246;175;Stellenweiser Regenfall;17;17;1
26.04.2020 19:00;332;180;152;Stellenweiser Regenfall;16;16;0
26.04.2020 20:00;211;112;99;Leichter Regenschauer;15;15;0
26.04.2020 21:00;101;49;52;Leichter Regenschauer;14;14;0
26.04.2020 22:00;61;28;33;Leichter Regenschauer;12;12;0
26.04.2020 23:00;26;15;11;Stellenweiser Regenfall;11;11;0
27.04.2020 00:00;25;13;12;Stellenweiser Regenfall;10;9;1
27.04.2020 01:00;13;9;4;Stellenweiser Regenfall;9;9;0
27.04.2020 02:00;3;1;2;Stellenweiser Regenfall;8;8;1
27.04.2020 03:00;6;2;4;Stellenweiser Regenfall;8;8;1
27.04.2020 04:00;12;10;2;Stellenweiser Regenfall;9;9;0
27.04.2020 05:00;36;16;20;Leichter Regenschauer;10;9;1
27.04.2020 06:00;157;108;49;Leichter Regenschauer;10;10;1
27.04.2020 07:00;318;211;107;Leichter Regenschauer;12;12;1
27.04.2020 08:00;361;224;137;Stellenweiser Regenfall;14;14;0
27.04.2020 09:00;336;198;138;Stellenweiser Regenfall;15;15;0
27.04.2020 10:00;352;191;161;Stellenweiser Regenfall;17;17;0
27.04.2020 11:00;434;203;231;Leicht bewölkt;18;18;0
27.04.2020 12:00;532;246;286;Leicht bewölkt;19;19;0
27.04.2020 13:00;497;219;278;Leicht bewölkt;20;20;0
27.04.2020 14:00;554;265;289;Leicht bewölkt;20;20;0
27.04.2020 15:00;642;296;346;Leicht bewölkt;21;21;0
27.04.2020 16:00;792;368;424;Leicht bewölkt;20;20;0
27.04.2020 17:00;725;309;416;Leicht bewölkt;20;20;0
27.04.2020 18:00;622;302;320;Leicht bewölkt;19;19;0
27.04.2020 19:00;449;237;212;Leicht bewölkt;18;18;0
27.04.2020 20:00;317;140;177;Leicht bewölkt;17;17;0
27.04.2020 21:00;177;93;84;Leicht bewölkt;16;16;0
27.04.2020 22:00;94;36;58;Leicht bewölkt;14;14;0
27.04.2020 23:00;55;33;22;Leicht bewölkt;12;12;0
28.04.2020 00:00;28;12;16;Leicht bewölkt;10;10;0
28.04.2020 01:00;14;10;4;Leicht bewölkt;10;10;0
28.04.2020 02:00;7;6;1;Leicht bewölkt;9;9;0
28.04.2020 03:00;2;1;1;Leicht bewölkt;9;9;0
28.04.2020 04:00;8;7;1;Leicht bewölkt;10;10;0
28.04.2020 05:00;34;20;14;Stellenweise Gewitter und Niederschläge;11;11;0
28.04.2020 06:00;137;97;40;Stellenweise Gewitter und Niederschläge;12;12;0
28.04.2020 07:00;324;202;122;Stellenweise Gewitter und Niederschläge;12;13;0
28.04.2020 08:00;360;237;123;Bedeckt;13;14;0
28.04.2020 09:00;197;100;97;Bedeckt;14;15;0
28.04.2020 10:00;218;107;111;Bedeckt;14;14;0
28.04.2020 11:00;211;114;97;Stellenweiser Regenfall;14;14;0
28.04.2020 12:00;261;106;155;Stellenweiser Regenfall;14;13;0
28.04.2020 13:00;288;149;139;Stellenweiser Regenfall;13;13;0
28.04.2020 14:00;311;143;168;Bewölkt;13;13;1
28.04.2020 15:00;336;162;174;Bewölkt;13;12;1
28.04.2020 16:00;480;216;264;Bewölkt;13;12;1
28.04.2020 17:00;497;225;272;Nieselregen;12;12;0
28.04.2020 18:00;421;164;257;Nieselregen;12;12;0
28.04.2020 19:00;268;130;138;Nieselregen;11;10;0
28.04.2020 20:00;165;83;82;Leicht bewölkt;11;9;3
28.04.2020 21:00;84;36;48;Leicht bewölkt;10;8;4
28.04.2020 22:00;46;27;19;Leicht bewölkt;10;8;2
28.04.2020 23:00;40;21;19;Leichter Regenfall;9;8;12
29.04.2020 00:00;21;12;9;Leichter Regenfall;9;7;23
29.04.2020 01:00;5;2;3;Leichter Regenfall;9;7;12
29.04.2020 02:00;4;1;3;Mäßiger Regenfall;9;7;12
29.04.2020 03:00;4;4;0;Mäßiger Regenfall;9;8;16
29.04.2020 04:00;15;9;6;Mäßiger Regenfall;9;7;8
29.04.2020 05:00;28;14;14;Mäßiger Regenfall;9;7;12
29.04.2020 06:00;105;72;33;Mäßiger Regenfall;9;7;16
29.04.2020 07:00;221;130;91;Mäßiger Regenfall;9;7;8
29.04.2020 08:00;188;111;77;Mäßiger Regenfall;9;7;14
29.04.2020 09:00;173;104;69;Mäßiger Regenfall;9;8;18
29.04.2020 10:00;165;85;80;Mäßiger Regenfall;10;9;9
29.04.2020 11:00;254;140;114;Mäßiger Regenfall;11;10;1
29.04.2020 12:00;283;134;149;Mäßiger Regenfall;12;11;13
29.04.2020 13:00;332;168;164;Mäßiger Regenfall;13;12;7
29.04.2020 14:00;418;211;207;Leichter Regenfall;14;13;4
29.04.2020 15:00;417;205;212;Leichter Regenfall;15;14;6
29.04.2020 16:00;555;275;280;Leichter Regenfall;14;13;3
29.04.2020 17:00;539;243;296;Stellenweiser Regenfall;13;13;1
29.04.2020 18:00;479;204;275;Stellenweiser Regenfall;13;12;1
29.04.2020 19:00;369;168;201;Stellenweiser Regenfall;11;10;1
29.04.2020 20:00;209;113;96;Leicht bewölkt;10;9;0
29.04.2020 21:00;102;46;56;Leicht bewölkt;8;7;0
29.04.2020 22:00;76;40;36;Leicht bewölkt;7;7;0
29.04.2020 23:00;48;26;22;Leicht bewölkt;7;6;0
30.04.2020 00:00;30;17;13;Leicht bewölkt;6;5;0
30.04.2020 01:00;29;14;15;Leicht bewölkt;6;5;0
30.04.2020 02:00;2;1;1;Leicht bewölkt;6;5;0
30.04.2020 03:00;2;0;2;Leicht bewölkt;6;5;0
30.04.2020 04:00;12;7;5;Leicht bewölkt;7;6;0
30.04.2020 05:00;37;23;14;Bedeckt;8;7;0
30.04.2020 06:00;123;82;41;Bedeckt;9;8;0
30.04.2020 07:00;265;165;100;Bedeckt;10;10;0
30.04.2020 08:00;274;160;114;Bedeckt;11;11;0
30.04.2020 09:00;227;139;88;Bedeckt;13;12;0
30.04.2020 10:00;259;144;115;Bedeckt;13;13;0
30.04.2020 11:00;284;160;124;Leicht bewölkt;14;13;0
30.04.2020 12:00;342;158;184;Leicht bewölkt;15;14;0
30.04.2020 13:00;344;171;173;Leicht bewölkt;14;13;0
30.04.2020 14:00;315;143;172;Bedeckt;13;12;1
30.04.2020 15:00;292;131;161;Bedeckt;12;11;14
30.04.2020 16:00;323;149;174;Bedeckt;11;10;7
30.04.2020 17:00;318;146;172;Mäßiger Regenfall;11;9;17
30.04.2020 18:00;342;142;200;Mäßiger Regenfall;10;9;23
30.04.2020 19:00;208;92;116;Mäßiger Regenfall;10;8;11
30.04.2020 20:00;158;73;85;Mäßiger Regenfall;9;8;6
30.04.2020 21:00;101;50;51;Mäßiger Regenfall;9;7;8
30.04.2020 22:00;52;29;23;Mäßiger Regenfall;8;7;4
30.04.2020 23:00;47;21;26;Stellenweiser Regenfall;7;6;0
01.05.2020 00:00;33;15;18;Stellenweiser Regenfall;7;5;0
01.05.2020 01:00;28;15;13;Stellenweiser Regenfall;7;5;0
01.05.2020 02:00;19;13;6;Bewölkt;7;5;0
01.05.2020 03:00;13;5;8;Bewölkt;7;6;0
01.05.2020 04:00;3;2;1;Bewölkt;7;6;0
01.05.2020 05:00;10;6;4;Leichter Regenschauer;8;6;2
01.05.2020 06:00;26;18;8;Leichter Regenschauer;8;7;3
01.05.2020 07:00;24;12;12;Leichter Regenschauer;9;7;1
01.05.2020 08:00;50;30;20;Leichter Regenfall;10;8;2
01.05.2020 09:00;84;34;50;Leichter Regenfall;11;9;2
01.05.2020 10:00;187;83;104;Leichter Regenfall;11;10;1
01.05.2020 11:00;251;108;143;Leichter Regenschauer;12;10;0
01.05.2020 12:00;286;148;138;Leichter Regenschauer;12;11;0
01.05.2020 13:00;206;110;96;Leichter Regenschauer;12;10;0
01.05.2020 14:00;222;121;101;Leicht bewölkt;11;10;6
01.05.2020 15:00;179;90;89;Leicht bewölkt;10;9;8
01.05.2020 16:00;146;81;65;Leicht bewölkt;10;9;4
01.05.2020 17:00;172;93;79;Mäßiger Regenfall;9;9;6
01.05.2020 18:00;137;81;56;Mäßiger Regenfall;9;8;8
01.05.2020 19:00;121;71;50;Mäßiger Regenfall;9;8;4
01.05.2020 20:00;112;58;54;Leichter Regenfall;8;8;9
01.05.2020 21:00;83;38;45;Leichter Regenfall;8;7;12
01.05.2020 22:00;46;18;28;Leichter Regenfall;8;7;6
01.05.2020 23:00;53;29;24;Teilweise mäßiger Regenfall;7;6;16
02.05.2020 00:00;52;29;23;Teilweise mäßiger Regenfall;7;6;32
02.05.2020 01:00;22;7;15;Teilweise mäßiger Regenfall;7;5;16
02.05.2020 02:00;15;10;5;Mäßiger bis starker Regen mit Gewitter;7;5;8
02.05.2020 03:00;6;1;5;Mäßiger bis starker Regen mit Gewitter;7;5;11
02.05.2020 04:00;11;5;6;Mäßiger bis starker Regen mit Gewitter;7;5;5
02.05.2020 05:00;14;8;6;Leichter Regenschauer;8;5;5
02.05.2020 06:00;30;14;16;Leichter Regenschauer;8;6;6
02.05.2020 07:00;47;19;28;Leichter Regenschauer;8;6;3
02.05.2020 08:00;102;52;50;Leichter Regenschauer;9;6;8
02.05.2020 09:00;180;92;88;Leichter Regenschauer;9;7;11
02.05.2020 10:00;165;97;68;Leichter Regenschauer;10;8;6
02.05.2020 11:00;214;99;115;Mäßiger Regenfall;11;9;13
02.05.2020 12:00;301;148;153;Mäßiger Regenfall;12;10;17
02.05.2020 13:00;349;173;176;Mäßiger Regenfall;12;10;8
02.05.2020 14:00;371;189;182;Mäßiger Regenfall;12;10;12
02.05.2020 15:00;374;190;184;Mäßiger Regenfall;12;9;16
02.05.2020 16:00;295;150;145;Mäßiger Regenfall;11;9;8
02.05.2020 17:00;239;97;142;Mäßiger bis starker Regenschauer;10;8;15
02.05.2020 18:00;147;67;80;Mäßiger bis starker Regenschauer;9;7;2
02.05.2020 19:00;172;79;93;Mäßiger bis starker Regenschauer;8;6;1
02.05.2020 20:00;163;76;87;Mäßiger bis starker Regenschauer;7;5;8
02.05.2020 21:00;100;54;46;Mäßiger bis starker Regenschauer;6;5;11
02.05.2020 22:00;39;17;22;Mäßiger bis starker Regenschauer;5;4;5
02.05.2020 23:00;41;19;22;Stellenweiser Regenfall;4;4;3
03.05.2020 00:00;41;21;20;Stellenweiser Regenfall;4;4;6
03.05.2020 01:00;31;16;15;Stellenweiser Regenfall;3;3;3
03.05.2020 02:00;15;6;9;Stellenweiser leichter Regenfall;3;3;1
03.05.2020 03:00;8;4;4;Stellenweiser leichter Regenfall;2;2;1
03.05.2020 04:00;5;2;3;Stellenweiser leichter Regenfall;3;3;1
03.05.2020 05:00;8;5;3;Leicht bewölkt;4;4;0
03.05.2020 06:00;20;15;5;Leicht bewölkt;5;5;0
03.05.2020 07:00;22;8;14;Leicht bewölkt;7;7;0
03.05.2020 08:00;49;19;30;Leicht bewölkt;9;9;0
03.05.2020 09:00;91;43;48;Leicht bewölkt;11;11;0
03.05.2020 10:00;166;74;92;Leicht bewölkt;13;13;0
03.05.2020 11:00;233;82;151;Leicht bewölkt;14;14;0
03.05.2020 12:00;309;123;186;Leicht bewölkt;16;16;0
03.05.2020 13:00;345;146;199;Leicht bewölkt;16;16;0
03.05.2020 14:00;445;214;231;Leicht bewölkt;16;16;0
03.05.2020 15:00;447;217;230;Leicht bewölkt;17;17;0
03.05.2020 16:00;454;263;191;Leicht bewölkt;16;16;0
03.05.2020 17:00;407;210;197;Leicht bewölkt;16;16;0
03.05.2020 18:00;403;221;182;Leicht bewölkt;15;15;0
03.05.2020 19:00;244;132;112;Leicht bewölkt;14;14;0
03.05.2020 20:00;133;65;68;Leicht bewölkt;13;13;0
03.05.2020 21:00;96;46;50;Leicht bewölkt;12;12;0
03.05.2020 22:00;75;40;35;Leicht bewölkt;11;11;0
03.05.2020 23:00;31;24;7;Nieselregen;10;9;1
04.05.2020 00:00;22;16;6;Nieselregen;9;8;2
04.05.2020 01:00;12;7;5;Nieselregen;8;7;1
04.05.2020 02:00;3;0;3;Stellenweiser Nieselregen;7;7;0
04.05.2020 03:00;3;2;1;Stellenweiser Nieselregen;7;6;0
04.05.2020 04:00;14;9;5;Stellenweiser Nieselregen;8;7;0
04.05.2020 05:00;39;24;15;Leicht bewölkt;8;8;0
04.05.2020 06:00;154;100;54;Leicht bewölkt;9;9;0
04.05.2020 07:00;445;299;146;Leicht bewölkt;11;11;0
04.05.2020 08:00;391;251;140;Bedeckt;13;13;0
04.05.2020 09:00;398;225;173;Bedeckt;14;14;0
04.05.2020 10:00;375;217;158;Bedeckt;16;16;0
04.05.2020 11:00;456;224;232;Stellenweiser Regenfall;17;17;1
04.05.2020 12:00;515;235;280;Stellenweiser Regenfall;18;18;1
04.05.2020 13:00;661;321;340;Stellenweiser Regenfall;19;19;0
04.05.2020 14:00;569;268;301;Stellenweiser Regenfall;19;19;2
04.05.2020 15:00;731;338;393;Stellenweiser Regenfall;19;19;3
04.05.2020 16:00;743;317;426;Stellenweiser Regenfall;18;18;2
04.05.2020 17:00;772;320;452;Stellenweiser Regenfall;17;17;1
04.05.2020 18:00;654;278;376;Stellenweiser Regenfall;17;17;1
04.05.2020 19:00;374;162;212;Stellenweiser Regenfall;15;15;1
04.05.2020 20:00;299;137;162;Leicht bewölkt;14;14;1
04.05.2020 21:00;157;84;73;Leicht bewölkt;13;13;1
04.05.2020 22:00;92;48;44;Leicht bewölkt;12;12;1
04.05.2020 23:00;54;27;27;Leichter Regenschauer;11;11;2
05.05.2020 00:00;29;19;10;Leichter Regenschauer;10;10;5
05.05.2020 01:00;8;4;4;Leichter Regenschauer;10;9;2
05.05.2020 02:00;7;4;3;Leichter Regenschauer;10;8;2
05.05.2020 03:00;2;0;2;Leichter Regenschauer;9;8;2
05.05.2020 04:00;9;8;1;Leichter Regenschauer;9;8;1
05.05.2020 05:00;37;20;17;Leichter Regenschauer;9;8;3
05.05.2020 06:00;154;98;56;Leichter Regenschauer;9;8;4
05.05.2020 07:00;389;258;131;Leichter Regenschauer;9;8;2
05.05.2020 08:00;405;274;131;Leichter Regenschauer;9;7;13
05.05.2020 09:00;320;183;137;Leichter Regenschauer;9;7;17
05.05.2020 10:00;223;120;103;Leichter Regenschauer;9;7;8
05.05.2020 11:00;274;124;150;Mäßiger Regenfall;9;7;2
05.05.2020 12:00;299;132;167;Mäßiger Regenfall;9;7;26
05.05.2020 13:00;319;156;163;Mäßiger Regenfall;9;8;13
05.05.2020 14:00;268;125;143;Mäßiger Regenfall;9;8;13
05.05.2020 15:00;355;167;188;Mäßiger Regenfall;9;9;17
05.05.2020 16:00;413;193;220;Mäßiger Regenfall;9;9;9
05.05.2020 17:00;486;206;280;Mäßiger Regenfall;9;9;18
05.05.2020 18:00;370;130;240;Mäßiger Regenfall;9;9;24
05.05.2020 19:00;231;100;131;Mäßiger Regenfall;9;9;12
05.05.2020 20:00;136;69;67;Mäßiger Regenfall;8;8;9
05.05.2020 21:00;83;42;41;Mäßiger Regenfall;8;8;12
05.05.2020 22:00;42;23;19;Mäßiger Regenfall;8;7;6
05.05.2020 23:00;30;12;18;Nieselregen;7;6;2
06.05.2020 00:00;31;8;23;Nieselregen;7;5;4
06.05.2020 01:00;15;11;4;Nieselregen;6;4;2
06.05.2020 02:00;2;1;1;Nieselregen;5;3;1
06.05.2020 03:00;1;0;1;Nieselregen;5;2;1
06.05.2020 04:00;8;6;2;Nieselregen;5;2;0
06.05.2020 05:00;38;23;15;Leicht bewölkt;5;3;0
06.05.2020 06:00;182;118;64;Leicht bewölkt;5;3;0
06.05.2020 07:00;440;281;159;Leicht bewölkt;7;5;0
06.05.2020 08:00;459;296;163;Stellenweiser Regenfall;8;7;0
06.05.2020 09:00;430;249;181;Stellenweiser Regenfall;10;8;0
06.05.2020 10:00;416;222;194;Stellenweiser Regenfall;11;10;0
06.05.2020 11:00;498;231;267;Stellenweiser Regenfall;13;11;0
06.05.2020 12:00;579;297;282;Stellenweiser Regenfall;14;13;0
06.05.2020 13:00;727;346;381;Stellenweiser Regenfall;14;13;0
06.05.2020 14:00;649;298;351;Stellenweiser Regenfall;15;14;0
06.05.2020 15:00;692;324;368;Stellenweiser Regenfall;15;14;0
06.05.2020 16:00;807;366;441;Stellenweiser Regenfall;14;14;0
06.05.2020 17:00;876;350;526;Sonnig;14;13;0
06.05.2020 18:00;697;310;387;Sonnig;14;13;0
06.05.2020 19:00;465;233;232;Sonnig;13;12;0
06.05.2020 20:00;335;162;173;Leicht bewölkt;12;12;0
06.05.2020 21:00;167;73;94;Leicht bewölkt;11;11;0
06.05.2020 22:00;92;44;48;Leicht bewölkt;10;9;0
06.05.2020 23:00;64;41;23;Leicht bewölkt;8;8;0
07.05.2020 00:00;37;22;15;Leicht bewölkt;7;7;0
07.05.2020 01:00;21;14;7;Leicht bewölkt;6;6;0
07.05.2020 02:00;9;5;4;Leicht bewölkt;5;5;0
07.05.2020 03:00;6;2;4;Leicht bewölkt;5;4;0
07.05.2020 04:00;7;4;3;Leicht bewölkt;6;6;0
07.05.2020 05:00;41;27;14;Leicht bewölkt;7;7;0
07.05.2020 06:00;159;97;62;Leicht bewölkt;8;8;0
07.05.2020 07:00;389;228;161;Leicht bewölkt;10;10;0
07.05.2020 08:00;441;272;169;Leicht bewölkt;12;12;0
07.05.2020 09:00;220;135;85;Leicht bewölkt;14;14;0
07.05.2020 10:00;0;0;0;Leicht bewölkt;16;16;0
07.05.2020 11:00;45;23;22;Sonnig;17;17;0
07.05.2020 12:00;591;263;328;Sonnig;19;19;0
07.05.2020 13:00;573;318;255;Sonnig;19;19;0
07.05.2020 14:00;667;314;353;Sonnig;19;19;0
07.05.2020 15:00;734;352;382;Sonnig;19;19;0
07.05.2020 16:00;873;391;482;Sonnig;19;19;0
07.05.2020 17:00;849;381;468;Sonnig;18;18;0
07.05.2020 18:00;815;342;473;Sonnig;18;18;0
07.05.2020 19:00;532;254;278;Sonnig;17;17;0
07.05.2020 20:00;367;162;205;Leicht bewölkt;16;16;0
07.05.2020 21:00;238;111;127;Leicht bewölkt;14;14;0
07.05.2020 22:00;106;49;57;Leicht bewölkt;13;13;0
07.05.2020 23:00;81;41;40;Leicht bewölkt;11;11;0
08.05.2020 00:00;60;28;32;Leicht bewölkt;9;9;0
08.05.2020 01:00;19;11;8;Leicht bewölkt;9;9;0
08.05.2020 02:00;21;9;12;Bedeckt;9;9;0
08.05.2020 03:00;7;4;3;Bedeckt;8;8;0
08.05.2020 04:00;12;9;3;Bedeckt;9;9;0
08.05.2020 05:00;30;21;9;Leicht bewölkt;11;11;0
08.05.2020 06:00;167;99;68;Leicht bewölkt;12;12;0
08.05.2020 07:00;400;263;137;Leicht bewölkt;14;14;0
08.05.2020 08:00;482;315;167;Leicht bewölkt;16;16;0
08.05.2020 09:00;487;291;196;Leicht bewölkt;18;18;0
08.05.2020 10:00;514;274;240;Leicht bewölkt;19;19;0
08.05.2020 11:00;605;276;329;Leicht bewölkt;20;20;0
08.05.2020 12:00;614;275;339;Leicht bewölkt;22;22;0
08.05.2020 13:00;645;275;370;Leicht bewölkt;22;24;0
08.05.2020 14:00;664;309;355;Leicht bewölkt;23;24;0
08.05.2020 15:00;762;352;410;Leicht bewölkt;23;25;0
08.05.2020 16:00;702;331;371;Leicht bewölkt;23;25;0
08.05.2020 17:00;764;374;390;Leicht bewölkt;23;24;0
08.05.2020 18:00;651;275;376;Leicht bewölkt;22;24;0
08.05.2020 19:00;542;254;288;Leicht bewölkt;21;21;0
08.05.2020 20:00;346;161;185;Stellenweiser Regenfall;20;20;0
08.05.2020 21:00;191;94;97;Stellenweiser Regenfall;20;20;0
08.05.2020 22:00;146;72;74;Stellenweiser Regenfall;18;18;0
08.05.2020 23:00;93;50;43;Stellenweiser Regenfall;16;16;1
09.05.2020 00:00;103;56;47;Stellenweiser Regenfall;14;15;3
09.05.2020 01:00;52;21;31;Stellenweiser Regenfall;13;14;1
09.05.2020 02:00;23;9;14;Teilweise mäßiger Regenfall;12;12;4
09.05.2020 03:00;24;11;13;Teilweise mäßiger Regenfall;11;11;5
09.05.2020 04:00;18;9;9;Teilweise mäßiger Regenfall;12;12;3
09.05.2020 05:00;17;6;11;Leichter Regenschauer;13;13;6
09.05.2020 06:00;32;20;12;Leichter Regenschauer;13;14;8
09.05.2020 07:00;75;37;38;Leichter Regenschauer;15;15;4
09.05.2020 08:00;144;68;76;Stellenweiser Regenfall;17;17;2
09.05.2020 09:00;290;180;110;Stellenweiser Regenfall;19;19;3
09.05.2020 10:00;434;229;205;Stellenweiser Regenfall;21;21;2
09.05.2020 11:00;509;243;266;Leicht bewölkt;22;24;0
09.05.2020 12:00;576;299;277;Leicht bewölkt;24;25;0
09.05.2020 13:00;666;319;347;Leicht bewölkt;24;25;0
09.05.2020 14:00;718;313;405;Leicht bewölkt;24;25;1
09.05.2020 15:00;734;337;397;Leicht bewölkt;24;26;1
09.05.2020 16:00;596;257;339;Leicht bewölkt;23;25;1
09.05.2020 17:00;663;315;348;Nieselregen mit Gewitter;22;25;2
09.05.2020 18:00;588;297;291;Nieselregen mit Gewitter;22;22;3
09.05.2020 19:00;473;241;232;Nieselregen mit Gewitter;21;21;1
09.05.2020 20:00;354;167;187;Teilweise mäßiger Regenfall;20;20;3
09.05.2020 21:00;258;148;110;Teilweise mäßiger Regenfall;19;19;4
09.05.2020 22:00;144;67;77;Teilweise mäßiger Regenfall;17;17;2
09.05.2020 23:00;108;57;51;Nieselregen mit Gewitter;16;16;7
10.05.2020 00:00;73;29;44;Nieselregen mit Gewitter;14;14;13
10.05.2020 01:00;67;34;33;Nieselregen mit Gewitter;14;13;7
10.05.2020 02:00;36;19;17;Mäßiger bis starker Regenschauer;13;13;4
10.05.2020 03:00;15;9;6;Mäßiger bis starker Regenschauer;12;12;5
10.05.2020 04:00;2;2;0;Mäßiger bis starker Regenschauer;12;12;2
10.05.2020 05:00;9;1;8;Leichter Regenschauer;12;13;7
10.05.2020 06:00;18;14;4;Leichter Regenschauer;13;13;9
10.05.2020 07:00;14;8;6;Leichter Regenschauer;13;13;4
10.05.2020 08:00;30;17;13;Mäßiger Regenfall;13;13;13
10.05.2020 09:00;93;43;50;Mäßiger Regenfall;14;13;18
10.05.2020 10:00;146;66;80;Mäßiger Regenfall;15;15;9
10.05.2020 11:00;167;78;89;Teilweise mäßiger Regenfall;17;17;12
10.05.2020 12:00;257;94;163;Teilweise mäßiger Regenfall;19;19;16
10.05.2020 13:00;374;132;242;Teilweise mäßiger Regenfall;20;20;8
10.05.2020 14:00;491;208;283;Teilweise mäßiger Regenfall;22;22;3
10.05.2020 15:00;485;220;265;Teilweise mäßiger Regenfall;23;25;4
10.05.2020 16:00;494;254;240;Teilweise mäßiger Regenfall;23;25;2
10.05.2020 17:00;463;230;233;Leicht bewölkt;23;25;0
10.05.2020 18:00;491;270;221;Leicht bewölkt;23;25;0
10.05.2020 19:00;421;242;179;Leicht bewölkt;22;25;0
10.05.2020 20:00;276;147;129;Leicht bewölkt;21;21;0
10.05.2020 21:00;180;90;90;Leicht bewölkt;20;20;0
10.05.2020 22:00;110;56;54;Leicht bewölkt;18;18;0
10.05.2020 23:00;58;22;36;Leicht bewölkt;16;16;0
11.05.2020 00:00;32;18;14;Leicht bewölkt;14;14;0
11.05.2020 01:00;14;10;4;Leicht bewölkt;12;12;0
11.05.2020 02:00;5;2;3;Leicht bewölkt;11;11;0
11.05.2020 03:00;4;3;1;Leicht bewölkt;10;10;0
11.05.2020 04:00;9;5;4;Leicht bewölkt;11;11;0
11.05.2020 05:00;39;24;15;Leicht bewölkt;12;12;0
11.05.2020 06:00;146;100;46;Leicht bewölkt;12;13;0
11.05.2020 07:00;419;285;134;Leicht bewölkt;14;14;0
11.05.2020 08:00;378;231;147;Leicht bewölkt;15;15;0
11.05.2020 09:00;390;240;150;Leicht bewölkt;16;17;0
11.05.2020 10:00;371;217;154;Leicht bewölkt;16;15;0
11.05.2020 11:00;482;230;252;Leicht bewölkt;15;14;0
11.05.2020 12:00;452;213;239;Leicht bewölkt;14;12;0
11.05.2020 13:00;491;224;267;Leicht bewölkt;13;11;0
11.05.2020 14:00;274;128;146;Bewölkt;12;10;7
11.05.2020 15:00;385;178;207;Bewölkt;11;9;9
11.05.2020 16:00;436;211;225;Bewölkt;9;8;4
11.05.2020 17:00;445;164;281;Mäßiger Regenfall;8;6;3
11.05.2020 18:00;393;149;244;Mäßiger Regenfall;7;5;4
11.05.2020 19:00;225;117;108;Mäßiger Regenfall;6;3;2
11.05.2020 20:00;104;52;52;Bedeckt;5;1;9
11.05.2020 21:00;76;36;40;Bedeckt;4;0;12
11.05.2020 22:00;38;14;24;Bedeckt;3;-1;6
11.05.2020 23:00;29;13;16;Starker Schneefall;2;-2;15
12.05.2020 00:00;30;6;24;Starker Schneefall;2;-3;29
12.05.2020 01:00;20;16;4;Starker Schneefall;1;-3;15
12.05.2020 02:00;7;5;2;Starker Schneefall;1;-3;6
12.05.2020 03:00;0;0;0;Starker Schneefall;1;-4;8
12.05.2020 04:00;7;4;3;Starker Schneefall;1;-3;4
12.05.2020 05:00;39;24;15;Starker Schneefall;2;-2;1
12.05.2020 06:00;159;102;57;Starker Schneefall;2;-1;2
12.05.2020 07:00;421;259;162;Starker Schneefall;3;0;1
12.05.2020 08:00;448;278;170;Leichter Eisregen;4;1;1
12.05.2020 09:00;417;253;164;Leichter Eisregen;6;3;1
12.05.2020 10:00;409;227;182;Leichter Eisregen;7;4;0
12.05.2020 11:00;485;234;251;Stellenweiser Regenfall;8;5;0
12.05.2020 12:00;499;210;289;Stellenweiser Regenfall;9;6;0
12.05.2020 13:00;517;248;269;Stellenweiser Regenfall;9;7;0
12.05.2020 14:00;535;256;279;Stellenweiser Regenfall;10;8;0
12.05.2020 15:00;602;278;324;Stellenweiser Regenfall;11;9;0
12.05.2020 16:00;677;316;361;Stellenweiser Regenfall;10;9;0
12.05.2020 17:00;790;337;453;Leicht bewölkt;10;9;0
12.05.2020 18:00;625;247;378;Leicht bewölkt;10;8;0
12.05.2020 19:00;400;188;212;Leicht bewölkt;9;7;0
12.05.2020 20:00;259;119;140;Bewölkt;8;7;0
12.05.2020 21:00;137;71;66;Bewölkt;7;6;0
12.05.2020 22:00;90;40;50;Bewölkt;7;5;0
12.05.2020 23:00;55;33;22;Leicht bewölkt;6;5;1
13.05.2020 00:00;41;17;24;Leicht bewölkt;6;4;3
13.05.2020 01:00;13;8;5;Leicht bewölkt;6;4;1
13.05.2020 02:00;9;3;6;Nieselregen;5;4;1
13.05.2020 03:00;4;1;3;Nieselregen;5;4;2
13.05.2020 04:00;9;5;4;Nieselregen;6;5;1
13.05.2020 05:00;38;22;16;Stellenweiser Nieselregen;7;6;1
13.05.2020 06:00;157;110;47;Stellenweiser Nieselregen;7;7;1
13.05.2020 07:00;391;238;153;Stellenweiser Nieselregen;8;7;1
13.05.2020 08:00;363;229;134;Stellenweiser Nieselregen;9;8;1
13.05.2020 09:00;320;160;160;Stellenweiser Nieselregen;9;8;1
13.05.2020 10:00;286;148;138;Stellenweiser Nieselregen;9;8;0
13.05.2020 11:00;324;182;142;Stellenweiser Regenfall;10;8;2
13.05.2020 12:00;348;167;181;Stellenweiser Regenfall;10;9;3
13.05.2020 13:00;424;209;215;Stellenweiser Regenfall;10;9;2
13.05.2020 14:00;391;190;201;Leichter Regenfall;11;10;2
13.05.2020 15:00;371;157;214;Leichter Regenfall;11;10;2
13.05.2020 16:00;493;233;260;Leichter Regenfall;11;10;1
13.05.2020 17:00;505;211;294;Stellenweiser Nieselregen;11;10;0
13.05.2020 18:00;424;170;254;Stellenweiser Nieselregen;11;9;0
13.05.2020 19:00;294;131;163;Stellenweiser Nieselregen;10;8;0
13.05.2020 20:00;150;76;74;Bedeckt;10;8;0
13.05.2020 21:00;91;45;46;Bedeckt;9;7;0
13.05.2020 22:00;67;32;35;Bedeckt;9;7;0
13.05.2020 23:00;61;30;31;Bedeckt;8;7;0
14.05.2020 00:00;31;8;23;Bedeckt;8;6;0
14.05.2020 01:00;12;8;4;Bedeckt;8;6;0
14.05.2020 02:00;16;3;13;Nebel;7;6;4
14.05.2020 03:00;1;0;1;Nebel;7;5;6
14.05.2020 04:00;6;5;1;Nebel;7;5;3
14.05.2020 05:00;31;16;15;Leichter Regenfall;7;5;3
14.05.2020 06:00;116;78;38;Leichter Regenfall;7;5;4
14.05.2020 07:00;349;203;146;Leichter Regenfall;8;5;2
14.05.2020 08:00;406;248;158;Nieselregen;8;6;0
14.05.2020 09:00;344;188;156;Nieselregen;9;6;0
14.05.2020 10:00;318;180;138;Nieselregen;10;8;0
14.05.2020 11:00;369;199;170;Stellenweiser Regenfall;11;9;0
14.05.2020 12:00;390;186;204;Stellenweiser Regenfall;12;10;0
14.05.2020 13:00;485;240;245;Stellenweiser Regenfall;13;11;0
14.05.2020 14:00;493;247;246;Leicht bewölkt;14;12;0
14.05.2020 15:00;498;234;264;Leicht bewölkt;14;13;0
14.05.2020 16:00;629;300;329;Leicht bewölkt;14;12;0
14.05.2020 17:00;602;253;349;Leicht bewölkt;14;12;0
14.05.2020 18:00;525;183;342;Leicht bewölkt;13;11;0
14.05.2020 19:00;344;138;206;Leicht bewölkt;13;11;0
14.05.2020 20:00;212;90;122;Bewölkt;12;10;0
14.05.2020 21:00;106;50;56;Bewölkt;12;10;0
14.05.2020 22:00;68;31;37;Bewölkt;12;9;0
14.05.2020 23:00;73;30;43;Bedeckt;11;9;0
15.05.2020 00:00;33;15;18;Bedeckt;11;9;0
15.05.2020 01:00;18;10;8;Bedeckt;11;9;0
15.05.2020 02:00;10;5;5;Bewölkt;11;8;0
15.05.2020 03:00;6;3;3;Bewölkt;10;8;0
15.05.2020 04:00;7;5;2;Bewölkt;10;7;0
15.05.2020 05:00;34;20;14;Stellenweiser Regenfall;9;6;7
15.05.2020 06:00;140;90;50;Stellenweiser Regenfall;9;6;9
15.05.2020 07:00;359;222;137;Stellenweiser Regenfall;8;5;4
15.05.2020 08:00;409;252;157;Mäßiger Regenfall;8;5;21
15.05.2020 09:00;416;269;147;Mäßiger Regenfall;7;5;28
15.05.2020 10:00;421;231;190;Mäßiger Regenfall;7;5;14
15.05.2020 11:00;508;260;248;Starker Regenfall;8;5;28
15.05.2020 12:00;481;211;270;Starker Regenfall;8;6;38
15.05.2020 13:00;567;236;331;Starker Regenfall;8;6;19
15.05.2020 14:00;489;243;246;Starker Regenfall;8;7;1
15.05.2020 15:00;490;238;252;Starker Regenfall;9;7;14
15.05.2020 16:00;534;248;286;Starker Regenfall;9;8;7
15.05.2020 17:00;545;227;318;Nieselregen;9;8;0
15.05.2020 18:00;490;183;307;Nieselregen;9;8;0
15.05.2020 19:00;368;169;199;Nieselregen;8;7;0
15.05.2020 20:00;241;91;150;Leicht bewölkt;7;7;0
15.05.2020 21:00;170;67;103;Leicht bewölkt;7;6;0
15.05.2020 22:00;87;41;46;Leicht bewölkt;6;5;0
15.05.2020 23:00;91;42;49;Leichter Nebel;5;4;0
16.05.2020 00:00;90;53;37;Bewölkt;5;3;0
16.05.2020 01:00;43;30;13;Bewölkt;5;2;0
16.05.2020 02:00;34;21;13;Leicht bewölkt;4;2;0
16.05.2020 03:00;18;8;10;Leicht bewölkt;4;2;0
16.05.2020 04:00;17;11;6;Leicht bewölkt;5;2;0
16.05.2020 05:00;22;12;10;Leicht bewölkt;6;3;0
16.05.2020 06:00;49;32;17;Leicht bewölkt;7;4;0
16.05.2020 07:00;69;25;44;Leicht bewölkt;8;6;0
16.05.2020 08:00;151;76;75;Bedeckt;9;7;0
16.05.2020 09:00;278;142;136;Bedeckt;10;9;0
16.05.2020 10:00;420;216;204;Bedeckt;11;10;0
16.05.2020 11:00;493;260;233;Bedeckt;12;11;0
16.05.2020 12:00;534;263;271;Bedeckt;13;13;0
16.05.2020 13:00;527;270;257;Bedeckt;14;13;0
16.05.2020 14:00;657;328;329;Bedeckt;15;14;0
16.05.2020 15:00;683;336;347;Bedeckt;15;15;0
16.05.2020 16:00;623;284;339;Bedeckt;15;14;0
16.05.2020 17:00;666;311;355;Bewölkt;14;13;0
16.05.2020 18:00;589;239;350;Bewölkt;13;13;0
16.05.2020 19:00;480;239;241;Bewölkt;12;11;0
16.05.2020 20:00;346;179;167;Leichter Regenschauer;11;10;0
16.05.2020 21:00;212;105;107;Leichter Regenschauer;10;9;0
16.05.2020 22:00;133;71;62;Leichter Regenschauer;9;8;0
16.05.2020 23:00;106;55;51;Leicht bewölkt;9;7;0
17.05.2020 00:00;95;49;46;Leicht bewölkt;8;7;0
17.05.2020 01:00;58;28;30;Leicht bewölkt;7;6;0
17.05.2020 02:00;59;23;36;Leicht bewölkt;7;6;0
17.05.2020 03:00;15;13;2;Leicht bewölkt;6;6;0
17.05.2020 04:00;10;9;1;Leicht bewölkt;7;7;0
17.05.2020 05:00;16;9;7;Leichter Nebel;8;8;0
17.05.2020 06:00;21;15;6;Leichter Nebel;9;9;0
17.05.2020 07:00;33;13;20;Leichter Nebel;11;10;0
17.05.2020 08:00;88;37;51;Leicht bewölkt;13;12;0
17.05.2020 09:00;156;74;82;Leicht bewölkt;14;14;0
17.05.2020 10:00;249;103;146;Leicht bewölkt;16;15;0
17.05.2020 11:00;350;127;223;Leicht bewölkt;17;17;0
17.05.2020 12:00;452;191;261;Leicht bewölkt;18;18;0
17.05.2020 13:00;523;200;323;Leicht bewölkt;19;19;0
17.05.2020 14:00;578;261;317;Leicht bewölkt;19;19;0
17.05.2020 15:00;601;301;300;Leicht bewölkt;20;20;0
17.05.2020 16:00;584;317;267;Leicht bewölkt;19;19;0
17.05.2020 17:00;605;324;281;Leicht bewölkt;18;18;0
17.05.2020 18:00;560;353;207;Leicht bewölkt;18;18;0
17.05.2020 19:00;409;215;194;Leicht bewölkt;16;16;0
17.05.2020 20:00;328;175;153;Leicht bewölkt;15;14;0
17.05.2020 21:00;184;90;94;Leicht bewölkt;13;13;0
17.05.2020 22:00;102;48;54;Leicht bewölkt;13;12;0
17.05.2020 23:00;51;30;21;Leicht bewölkt;12;11;0
18.05.2020 00:00;38;17;21;Leicht bewölkt;11;10;0
18.05.2020 01:00;16;6;10;Leicht bewölkt;10;9;0
18.05.2020 02:00;4;4;0;Leicht bewölkt;9;9;0
18.05.2020 03:00;5;2;3;Leicht bewölkt;8;8;0
18.05.2020 04:00;6;5;1;Leicht bewölkt;9;9;0
18.05.2020 05:00;40;22;18;Leicht bewölkt;10;10;0
18.05.2020 06:00;163;106;57;Leicht bewölkt;10;10;0
18.05.2020 07:00;536;345;191;Leicht bewölkt;12;12;0
18.05.2020 08:00;551;336;215;Leicht bewölkt;14;14;0
18.05.2020 09:00;507;283;224;Leicht bewölkt;16;16;0
18.05.2020 10:00;416;221;195;Leicht bewölkt;17;17;0
18.05.2020 11:00;529;245;284;Leicht bewölkt;18;18;0
18.05.2020 12:00;627;311;316;Leicht bewölkt;20;20;0
18.05.2020 13:00;744;357;387;Leicht bewölkt;20;20;0
18.05.2020 14:00;689;370;319;Leicht bewölkt;20;20;0
18.05.2020 15:00;777;361;416;Leicht bewölkt;21;21;0
18.05.2020 16:00;842;412;430;Leicht bewölkt;20;20;0
18.05.2020 17:00;950;439;511;Leicht bewölkt;19;19;0
18.05.2020 18:00;884;366;518;Leicht bewölkt;18;18;0
18.05.2020 19:00;591;248;343;Leicht bewölkt;17;17;0
18.05.2020 20:00;423;201;222;Leicht bewölkt;16;16;0
18.05.2020 21:00;292;121;171;Leicht bewölkt;15;15;0
18.05.2020 22:00;169;62;107;Leicht bewölkt;13;13;0
18.05.2020 23:00;61;30;31;Leicht bewölkt;12;12;0
19.05.2020 00:00;54;18;36;Leicht bewölkt;11;11;0
19.05.2020 01:00;20;10;10;Leicht bewölkt;10;10;0
19.05.2020 02:00;15;8;7;Leicht bewölkt;10;10;0
19.05.2020 03:00;3;2;1;Leicht bewölkt;9;9;0
19.05.2020 04:00;11;7;4;Leicht bewölkt;10;10;0
19.05.2020 05:00;47;33;14;Leicht bewölkt;11;12;0
19.05.2020 06:00;177;108;69;Leicht bewölkt;12;13;0
19.05.2020 07:00;470;290;180;Leicht bewölkt;14;14;0
19.05.2020 08:00;616;368;248;Leicht bewölkt;15;16;0
19.05.2020 09:00;498;289;209;Leicht bewölkt;17;17;0
19.05.2020 10:00;546;304;242;Leicht bewölkt;18;18;0
19.05.2020 11:00;634;313;321;Leicht bewölkt;19;19;0
19.05.2020 12:00;674;308;366;Leicht bewölkt;21;21;0
19.05.2020 13:00;738;365;373;Leicht bewölkt;21;21;0
19.05.2020 14:00;782;376;406;Leicht bewölkt;21;21;1
19.05.2020 15:00;800;369;431;Leicht bewölkt;21;21;2
19.05.2020 16:00;916;424;492;Leicht bewölkt;20;20;1
19.05.2020 17:00;1057;506;551;Teilweise mäßiger Regenfall;19;19;4
19.05.2020 18:00;805;346;459;Teilweise mäßiger Regenfall;18;18;6
19.05.2020 19:00;642;297;345;Teilweise mäßiger Regenfall;17;17;3
19.05.2020 20:00;402;165;237;Stellenweiser Regenfall;16;16;2
19.05.2020 21:00;244;110;134;Stellenweiser Regenfall;15;15;3
19.05.2020 22:00;147;60;87;Stellenweiser Regenfall;13;13;2
19.05.2020 23:00;82;35;47;Stellenweiser Regenfall;12;12;1
20.05.2020 00:00;36;8;28;Stellenweiser Regenfall;11;11;1
20.05.2020 01:00;32;16;16;Stellenweiser Regenfall;10;10;1
20.05.2020 02:00;14;5;9;Leichter Regenschauer;10;9;0
20.05.2020 03:00;3;2;1;Leichter Regenschauer;9;9;0
20.05.2020 04:00;10;7;3;Leichter Regenschauer;10;10;0
20.05.2020 05:00;55;33;22;Leichter Nebel;11;11;0
20.05.2020 06:00;176;117;59;Leichter Nebel;12;12;0
20.05.2020 07:00;473;286;187;Leichter Nebel;13;13;0
20.05.2020 08:00;576;362;214;Leicht bewölkt;15;15;0
20.05.2020 09:00;465;276;189;Leicht bewölkt;17;17;0
20.05.2020 10:00;469;260;209;Leicht bewölkt;18;18;0
20.05.2020 11:00;582;303;279;Leicht bewölkt;19;19;0
20.05.2020 12:00;672;331;341;Leicht bewölkt;20;20;0
20.05.2020 13:00;735;360;375;Leicht bewölkt;20;20;0
20.05.2020 14:00;760;380;380;Leicht bewölkt;21;21;0
20.05.2020 15:00;833;389;444;Leicht bewölkt;21;21;0
20.05.2020 16:00;958;422;536;Leicht bewölkt;20;20;0
20.05.2020 17:00;967;414;553;Stellenweiser Regenfall;19;19;0
20.05.2020 18:00;827;349;478;Stellenweiser Regenfall;18;18;0
20.05.2020 19:00;587;287;300;Stellenweiser Regenfall;17;17;0
20.05.2020 20:00;449;226;223;Leicht bewölkt;16;16;0
20.05.2020 21:00;278;124;154;Leicht bewölkt;14;14;0
20.05.2020 22:00;164;63;101;Leicht bewölkt;13;13;0
20.05.2020 23:00;128;55;73;Leicht bewölkt;12;12;0
21.05.2020 00:00;147;61;86;Leicht bewölkt;11;11;0
21.05.2020 01:00;71;31;40;Leicht bewölkt;11;10;0
21.05.2020 02:00;34;13;21;Leicht bewölkt;10;10;0
21.05.2020 03:00;10;2;8;Leicht bewölkt;10;9;0
21.05.2020 04:00;16;11;5;Leicht bewölkt;11;11;0
21.05.2020 05:00;8;3;5;Leicht bewölkt;12;12;0
21.05.2020 06:00;35;16;19;Leicht bewölkt;13;13;0
21.05.2020 07:00;53;25;28;Leicht bewölkt;15;15;0
21.05.2020 08:00;120;43;77;Leicht bewölkt;17;17;0
21.05.2020 09:00;234;109;125;Leicht bewölkt;18;18;0
21.05.2020 10:00;321;119;202;Leicht bewölkt;19;19;0
21.05.2020 11:00;495;202;293;Leicht bewölkt;20;20;0
21.05.2020 12:00;478;197;281;Leicht bewölkt;21;21;0
21.05.2020 13:00;547;266;281;Leicht bewölkt;22;22;0
21.05.2020 14:00;671;327;344;Leicht bewölkt;22;22;0
21.05.2020 15:00;543;234;309;Leicht bewölkt;22;25;0
21.05.2020 16:00;641;323;318;Leicht bewölkt;21;21;0
21.05.2020 17:00;658;363;295;Leicht bewölkt;20;20;0
21.05.2020 18:00;660;387;273;Leicht bewölkt;19;19;0
21.05.2020 19:00;560;316;244;Leicht bewölkt;18;18;0
21.05.2020 20:00;477;279;198;Stellenweiser Regenfall;16;16;0
21.05.2020 21:00;292;149;143;Stellenweiser Regenfall;15;15;0
21.05.2020 22:00;192;85;107;Stellenweiser Regenfall;14;14;0
21.05.2020 23:00;127;63;64;Stellenweiser Regenfall;13;13;0
22.05.2020 00:00;100;57;43;Stellenweiser Regenfall;12;13;1
22.05.2020 01:00;46;21;25;Stellenweiser Regenfall;12;12;0
22.05.2020 02:00;19;11;8;Stellenweiser Regenfall;12;12;0
22.05.2020 03:00;14;6;8;Stellenweiser Regenfall;11;12;0
22.05.2020 04:00;22;15;7;Stellenweiser Regenfall;12;12;0
22.05.2020 05:00;30;18;12;Leicht bewölkt;13;13;0
22.05.2020 06:00;101;63;38;Leicht bewölkt;14;14;0
22.05.2020 07:00;280;162;118;Leicht bewölkt;16;16;0
22.05.2020 08:00;393;263;130;Leicht bewölkt;18;18;0
22.05.2020 09:00;516;313;203;Leicht bewölkt;19;19;0
22.05.2020 10:00;715;397;318;Leicht bewölkt;20;20;0
22.05.2020 11:00;736;390;346;Bedeckt;21;21;0
22.05.2020 12:00;744;380;364;Bedeckt;22;25;0
22.05.2020 13:00;747;341;406;Bedeckt;23;25;0
22.05.2020 14:00;831;426;405;Leicht bewölkt;23;25;0
22.05.2020 15:00;840;420;420;Leicht bewölkt;24;25;0
22.05.2020 16:00;843;360;483;Leicht bewölkt;23;24;0
22.05.2020 17:00;817;394;423;Leicht bewölkt;22;23;0
22.05.2020 18:00;824;368;456;Leicht bewölkt;21;21;0
22.05.2020 19:00;492;222;270;Leicht bewölkt;20;20;0
22.05.2020 20:00;337;149;188;Bewölkt;19;19;0
22.05.2020 21:00;260;114;146;Bewölkt;18;18;0
22.05.2020 22:00;144;64;80;Bewölkt;17;17;0
22.05.2020 23:00;132;58;74;Stellenweiser Regenfall;16;17;0
23.05.2020 00:00;113;56;57;Stellenweiser Regenfall;16;16;0
23.05.2020 01:00;88;53;35;Stellenweiser Regenfall;15;16;0
23.05.2020 02:00;43;23;20;Leicht bewölkt;15;16;4
23.05.2020 03:00;23;14;9;Leicht bewölkt;15;15;5
23.05.2020 04:00;6;3;3;Leicht bewölkt;16;16;2
23.05.2020 05:00;17;11;6;Leichter Regenschauer;16;16;2
23.05.2020 06:00;53;33;20;Leichter Regenschauer;17;17;3
23.05.2020 07:00;70;36;34;Leichter Regenschauer;18;18;2
23.05.2020 08:00;154;74;80;Stellenweiser Regenfall;19;19;2
23.05.2020 09:00;296;167;129;Stellenweiser Regenfall;20;20;2
23.05.2020 10:00;307;156;151;Stellenweiser Regenfall;19;18;1
23.05.2020 11:00;418;234;184;Stellenweiser Regenfall;18;17;1
23.05.2020 12:00;524;280;244;Stellenweiser Regenfall;17;15;14
23.05.2020 13:00;224;100;124;Stellenweiser Regenfall;15;14;7
23.05.2020 14:00;207;94;113;Mäßiger bis starker Regenschauer;13;12;17
23.05.2020 15:00;188;85;103;Mäßiger bis starker Regenschauer;11;10;22
23.05.2020 16:00;147;55;92;Mäßiger bis starker Regenschauer;10;9;11
23.05.2020 17:00;164;77;87;Mäßiger Regenfall;9;8;22
23.05.2020 18:00;155;64;91;Mäßiger Regenfall;8;8;29
23.05.2020 19:00;142;61;81;Mäßiger Regenfall;7;7;15
23.05.2020 20:00;136;75;61;Mäßiger Regenfall;6;6;9
23.05.2020 21:00;115;59;56;Mäßiger Regenfall;6;6;12
23.05.2020 22:00;80;36;44;Mäßiger Regenfall;6;6;6
23.05.2020 23:00;69;34;35;Stellenweiser Nieselregen;6;6;2
24.05.2020 00:00;52;18;34;Stellenweiser Nieselregen;7;6;5
24.05.2020 01:00;39;17;22;Stellenweiser Nieselregen;6;6;2
24.05.2020 02:00;29;19;10;Stellenweiser Nieselregen;6;6;1
24.05.2020 03:00;8;6;2;Stellenweiser Nieselregen;6;5;1
24.05.2020 04:00;12;7;5;Stellenweiser Nieselregen;6;6;0
24.05.2020 05:00;14;4;10;Leicht bewölkt;7;7;0
24.05.2020 06:00;29;18;11;Leicht bewölkt;7;7;0
24.05.2020 07:00;37;24;13;Leicht bewölkt;9;9;0
24.05.2020 08:00;71;33;38;Leicht bewölkt;11;11;0
24.05.2020 09:00;187;82;105;Leicht bewölkt;13;13;0
24.05.2020 10:00;235;97;138;Leicht bewölkt;14;14;0
24.05.2020 11:00;299;119;180;Leicht bewölkt;15;15;0
24.05.2020 12:00;386;193;193;Leicht bewölkt;16;16;0
24.05.2020 13:00;276;121;155;Leicht bewölkt;16;16;0
24.05.2020 14:00;382;177;205;Leicht bewölkt;17;17;0
24.05.2020 15:00;460;255;205;Leicht bewölkt;17;17;0
24.05.2020 16:00;488;295;193;Leicht bewölkt;17;17;0
24.05.2020 17:00;440;232;208;Stellenweiser Regenfall;16;16;0
24.05.2020 18:00;479;258;221;Stellenweiser Regenfall;16;16;0
24.05.2020 19:00;370;203;167;Stellenweiser Regenfall;14;14;0
24.05.2020 20:00;256;129;127;Leicht bewölkt;13;13;0
24.05.2020 21:00;151;62;89;Leicht bewölkt;12;12;0
24.05.2020 22:00;118;53;65;Leicht bewölkt;11;11;0
24.05.2020 23:00;51;24;27;Leicht bewölkt;10;10;0
25.05.2020 00:00;36;13;23;Leicht bewölkt;9;9;0
25.05.2020 01:00;21;12;9;Leicht bewölkt;8;8;0
25.05.2020 02:00;4;2;2;Leicht bewölkt;8;8;0
25.05.2020 03:00;4;2;2;Leicht bewölkt;7;7;0
25.05.2020 04:00;6;4;2;Leicht bewölkt;8;8;0
25.05.2020 05:00;50;27;23;Leicht bewölkt;9;9;0
25.05.2020 06:00;193;123;70;Leicht bewölkt;10;10;0
25.05.2020 07:00;483;296;187;Leicht bewölkt;12;12;0
25.05.2020 08:00;571;351;220;Leicht bewölkt;13;13;0
25.05.2020 09:00;502;298;204;Leicht bewölkt;15;15;0
25.05.2020 10:00;462;263;199;Leicht bewölkt;16;16;0
25.05.2020 11:00;499;245;254;Stellenweiser Regenfall;17;17;0
25.05.2020 12:00;627;291;336;Stellenweiser Regenfall;18;18;0
25.05.2020 13:00;729;336;393;Stellenweiser Regenfall;19;19;0
25.05.2020 14:00;673;328;345;Leicht bewölkt;19;19;0
25.05.2020 15:00;682;364;318;Leicht bewölkt;19;19;0
25.05.2020 16:00;777;365;412;Leicht bewölkt;18;18;0
25.05.2020 17:00;879;394;485;Stellenweiser Regenfall;17;17;0
25.05.2020 18:00;758;300;458;Stellenweiser Regenfall;16;16;0
25.05.2020 19:00;510;253;257;Stellenweiser Regenfall;15;15;0
25.05.2020 20:00;359;158;201;Leicht bewölkt;14;14;0
25.05.2020 21:00;253;112;141;Leicht bewölkt;12;12;0
25.05.2020 22:00;125;55;70;Leicht bewölkt;11;11;0
25.05.2020 23:00;83;35;48;Stellenweiser Regenfall;10;10;0
26.05.2020 00:00;46;22;24;Stellenweiser Regenfall;9;8;1
26.05.2020 01:00;19;13;6;Stellenweiser Regenfall;8;8;0
26.05.2020 02:00;6;3;3;Stellenweiser Regenfall;8;7;0
26.05.2020 03:00;7;5;2;Stellenweiser Regenfall;7;7;0
26.05.2020 04:00;8;5;3;Stellenweiser Regenfall;8;8;0
26.05.2020 05:00;55;36;19;Leicht bewölkt;9;9;0
26.05.2020 06:00;191;107;84;Leicht bewölkt;10;11;0
26.05.2020 07:00;502;308;194;Leicht bewölkt;12;12;0
26.05.2020 08:00;627;400;227;Leicht bewölkt;13;13;0
26.05.2020 09:00;516;289;227;Leicht bewölkt;15;15;0
26.05.2020 10:00;513;284;229;Leicht bewölkt;16;16;0
26.05.2020 11:00;641;350;291;Leicht bewölkt;17;17;0
26.05.2020 12:00;712;344;368;Leicht bewölkt;17;17;0
26.05.2020 13:00;752;363;389;Leicht bewölkt;18;18;0
26.05.2020 14:00;793;402;391;Leicht bewölkt;18;18;0
26.05.2020 15:00;802;411;391;Leicht bewölkt;18;18;0
26.05.2020 16:00;875;420;455;Leicht bewölkt;17;17;0
26.05.2020 17:00;1027;444;583;Leicht bewölkt;16;16;0
26.05.2020 18:00;874;410;464;Leicht bewölkt;15;15;0
26.05.2020 19:00;591;273;318;Leicht bewölkt;14;14;0
26.05.2020 20:00;468;227;241;Leicht bewölkt;13;13;0
26.05.2020 21:00;277;113;164;Leicht bewölkt;12;12;0
26.05.2020 22:00;206;81;125;Leicht bewölkt;11;10;0
26.05.2020 23:00;83;40;43;Leicht bewölkt;10;9;0
27.05.2020 00:00;70;25;45;Leicht bewölkt;9;8;0
27.05.2020 01:00;19;10;9;Leicht bewölkt;8;7;0
27.05.2020 02:00;15;7;8;Leicht bewölkt;7;6;0
27.05.2020 03:00;7;4;3;Leicht bewölkt;6;5;0
27.05.2020 04:00;15;10;5;Leicht bewölkt;7;6;0
27.05.2020 05:00;49;33;16;Bedeckt;8;7;0
27.05.2020 06:00;185;115;70;Bedeckt;9;8;0
27.05.2020 07:00;544;308;236;Bedeckt;11;10;0
27.05.2020 08:00;559;327;232;Leicht bewölkt;13;12;0
27.05.2020 09:00;496;316;180;Leicht bewölkt;15;15;0
27.05.2020 10:00;512;301;211;Leicht bewölkt;16;16;0
27.05.2020 11:00;633;317;316;Leicht bewölkt;17;17;0
27.05.2020 12:00;688;322;366;Leicht bewölkt;18;18;0
27.05.2020 13:00;745;339;406;Leicht bewölkt;19;19;0
27.05.2020 14:00;803;412;391;Leicht bewölkt;19;19;0
27.05.2020 15:00;863;403;460;Leicht bewölkt;19;19;0
27.05.2020 16:00;933;446;487;Leicht bewölkt;18;18;0
27.05.2020 17:00;1020;450;570;Leicht bewölkt;18;18;0
27.05.2020 18:00;1021;442;579;Leicht bewölkt;17;17;0
27.05.2020 19:00;633;295;338;Leicht bewölkt;16;16;0
27.05.2020 20:00;513;245;268;Leicht bewölkt;15;15;0
27.05.2020 21:00;444;197;247;Leicht bewölkt;14;14;0
27.05.2020 22:00;214;90;124;Leicht bewölkt;13;13;0
27.05.2020 23:00;163;63;100;Leicht bewölkt;11;11;0
28.05.2020 00:00;65;28;37;Leicht bewölkt;10;10;0
28.05.2020 01:00;36;18;18;Leicht bewölkt;9;9;0
28.05.2020 02:00;13;5;8;Leicht bewölkt;8;8;0
28.05.2020 03:00;7;4;3;Leicht bewölkt;8;8;0
28.05.2020 04:00;17;10;7;Leicht bewölkt;9;9;0
28.05.2020 05:00;34;17;17;Leicht bewölkt;10;10;0
28.05.2020 06:00;171;107;64;Leicht bewölkt;11;11;0
28.05.2020 07:00;472;260;212;Leicht bewölkt;13;13;0
28.05.2020 08:00;639;379;260;Leicht bewölkt;14;14;0
28.05.2020 09:00;458;257;201;Leicht bewölkt;16;16;0
28.05.2020 10:00;542;337;205;Leicht bewölkt;16;16;0
28.05.2020 11:00;553;288;265;Stellenweiser Regenfall;17;17;2
28.05.2020 12:00;679;332;347;Stellenweiser Regenfall;17;17;3
28.05.2020 13:00;750;364;386;Stellenweiser Regenfall;17;17;1
28.05.2020 14:00;730;374;356;Stellenweiser Regenfall;17;17;4
28.05.2020 15:00;775;373;402;Stellenweiser Regenfall;17;17;6
28.05.2020 16:00;811;374;437;Stellenweiser Regenfall;16;16;3
28.05.2020 17:00;908;444;464;Stellenweiser Regenfall;15;15;6
28.05.2020 18:00;811;356;455;Stellenweiser Regenfall;15;14;8
28.05.2020 19:00;592;299;293;Stellenweiser Regenfall;13;12;4
28.05.2020 20:00;398;191;207;Stellenweiser Regenfall;12;10;2
28.05.2020 21:00;281;110;171;Stellenweiser Regenfall;11;9;3
28.05.2020 22:00;246;93;153;Stellenweiser Regenfall;10;7;1
28.05.2020 23:00;160;61;99;Leicht bewölkt;8;6;0
29.05.2020 00:00;92;42;50;Leicht bewölkt;7;5;0
29.05.2020 01:00;39;17;22;Leicht bewölkt;7;5;0
29.05.2020 02:00;13;10;3;Leicht bewölkt;6;4;0
29.05.2020 03:00;8;4;4;Leicht bewölkt;6;4;0
29.05.2020 04:00;8;6;2;Leicht bewölkt;7;5;0
29.05.2020 05:00;38;24;14;Leicht bewölkt;8;6;0
29.05.2020 06:00;165;98;67;Leicht bewölkt;9;6;0
29.05.2020 07:00;447;259;188;Leicht bewölkt;10;9;0
29.05.2020 08:00;566;343;223;Leicht bewölkt;12;11;0
29.05.2020 09:00;530;315;215;Leicht bewölkt;14;13;0
29.05.2020 10:00;637;358;279;Leicht bewölkt;15;14;0
29.05.2020 11:00;667;330;337;Leicht bewölkt;16;16;0
29.05.2020 12:00;716;347;369;Leicht bewölkt;17;17;0
29.05.2020 13:00;838;367;471;Leicht bewölkt;17;17;0
29.05.2020 14:00;839;411;428;Leicht bewölkt;18;18;0
29.05.2020 15:00;795;394;401;Leicht bewölkt;18;18;0
29.05.2020 16:00;803;403;400;Leicht bewölkt;17;17;0
29.05.2020 17:00;768;377;391;Leicht bewölkt;16;16;0
29.05.2020 18:00;758;336;422;Leicht bewölkt;16;15;0
29.05.2020 19:00;588;276;312;Leicht bewölkt;14;13;0
29.05.2020 20:00;459;229;230;Leicht bewölkt;13;11;0
29.05.2020 21:00;315;122;193;Leicht bewölkt;12;10;0
29.05.2020 22:00;184;63;121;Leicht bewölkt;11;8;0
29.05.2020 23:00;185;66;119;Leicht bewölkt;10;7;0
30.05.2020 00:00;118;48;70;Leicht bewölkt;9;6;0
30.05.2020 01:00;79;39;40;Leicht bewölkt;8;6;0
30.05.2020 02:00;51;25;26;Leicht bewölkt;8;6;0
30.05.2020 03:00;13;8;5;Leicht bewölkt;7;5;0
30.05.2020 04:00;11;7;4;Leicht bewölkt;8;6;0
30.05.2020 05:00;23;11;12;Leicht bewölkt;9;7;0
30.05.2020 06:00;51;26;25;Leicht bewölkt;10;8;0
30.05.2020 07:00;89;31;58;Leicht bewölkt;11;10;0
30.05.2020 08:00;212;94;118;Leicht bewölkt;12;12;0
30.05.2020 09:00;362;209;153;Leicht bewölkt;14;13;0
30.05.2020 10:00;542;306;236;Leicht bewölkt;15;15;0
30.05.2020 11:00;680;372;308;Leicht bewölkt;16;16;0
30.05.2020 12:00;709;394;315;Leicht bewölkt;17;17;0
30.05.2020 13:00;726;355;371;Leicht bewölkt;17;17;0
30.05.2020 14:00;790;393;397;Leicht bewölkt;17;17;0
30.05.2020 15:00;811;426;385;Leicht bewölkt;17;17;0
30.05.2020 16:00;685;339;346;Leicht bewölkt;16;16;0
30.05.2020 17:00;658;322;336;Leicht bewölkt;15;15;0
30.05.2020 18:00;613;294;319;Leicht bewölkt;14;14;0
30.05.2020 19:00;435;194;241;Leicht bewölkt;13;12;0
30.05.2020 20:00;362;162;200;Leicht bewölkt;12;10;0
30.05.2020 21:00;303;139;164;Leicht bewölkt;10;9;0
30.05.2020 22:00;204;87;117;Leicht bewölkt;9;8;0
30.05.2020 23:00;149;65;84;Leicht bewölkt;8;7;0
31.05.2020 00:00;94;47;47;Leicht bewölkt;8;6;0
31.05.2020 01:00;100;52;48;Leicht bewölkt;7;5;0
31.05.2020 02:00;62;35;27;Leicht bewölkt;6;5;0
31.05.2020 03:00;30;13;17;Leicht bewölkt;6;4;0
31.05.2020 04:00;10;5;5;Leicht bewölkt;7;5;0
31.05.2020 05:00;20;7;13;Leicht bewölkt;8;7;0
31.05.2020 06:00;27;14;13;Leicht bewölkt;9;8;0
31.05.2020 07:00;46;19;27;Leicht bewölkt;10;10;0
31.05.2020 08:00;114;46;68;Leicht bewölkt;12;11;0
31.05.2020 09:00;216;87;129;Leicht bewölkt;13;13;0
31.05.2020 10:00;322;147;175;Leicht bewölkt;14;14;0
31.05.2020 11:00;401;172;229;Leicht bewölkt;15;15;0
31.05.2020 12:00;472;203;269;Leicht bewölkt;16;16;0
31.05.2020 13:00;518;264;254;Leicht bewölkt;17;17;0
31.05.2020 14:00;613;300;313;Leicht bewölkt;17;17;0
31.05.2020 15:00;610;328;282;Leicht bewölkt;17;17;0
31.05.2020 16:00;604;357;247;Leicht bewölkt;17;17;0
31.05.2020 17:00;651;366;285;Leicht bewölkt;16;16;0
31.05.2020 18:00;561;299;262;Leicht bewölkt;16;15;0
31.05.2020 19:00;465;288;177;Leicht bewölkt;15;14;0
31.05.2020 20:00;336;199;137;Leicht bewölkt;14;14;0
31.05.2020 21:00;234;105;129;Leicht bewölkt;14;13;0
31.05.2020 22:00;175;69;106;Leicht bewölkt;12;12;0
31.05.2020 23:00;105;43;62;Leicht bewölkt;11;10;0
01.06.2020 00:00;85;34;51;Leicht bewölkt;10;9;0
01.06.2020 01:00;37;21;16;Leicht bewölkt;9;8;0
01.06.2020 02:00;15;8;7;Leicht bewölkt;8;7;0
01.06.2020 03:00;14;9;5;Leicht bewölkt;8;6;0
01.06.2020 04:00;22;15;7;Leicht bewölkt;9;7;0
01.06.2020 05:00;12;5;7;Leicht bewölkt;10;9;0
01.06.2020 06:00;29;17;12;Leicht bewölkt;11;10;0
01.06.2020 07:00;46;27;19;Leicht bewölkt;13;12;0
01.06.2020 08:00;105;43;62;Leicht bewölkt;15;14;0
01.06.2020 09:00;221;106;115;Leicht bewölkt;16;16;0
01.06.2020 10:00;328;139;189;Leicht bewölkt;18;18;0
01.06.2020 11:00;487;215;272;Leicht bewölkt;19;19;0
01.06.2020 12:00;540;262;278;Leicht bewölkt;20;20;0
01.06.2020 13:00;566;286;280;Leicht bewölkt;20;20;0
01.06.2020 14:00;588;301;287;Leicht bewölkt;21;21;0
01.06.2020 15:00;649;330;319;Leicht bewölkt;21;21;0
01.06.2020 16:00;633;372;261;Leicht bewölkt;20;20;0
01.06.2020 17:00;617;321;296;Leicht bewölkt;20;20;0
01.06.2020 18:00;642;307;335;Leicht bewölkt;19;19;0
01.06.2020 19:00;552;301;251;Leicht bewölkt;17;17;0
01.06.2020 20:00;377;194;183;Leicht bewölkt;16;16;0
01.06.2020 21:00;311;161;150;Leicht bewölkt;15;14;0
01.06.2020 22:00;183;89;94;Leicht bewölkt;14;14;0
01.06.2020 23:00;95;46;49;Sonnig;13;13;0
02.06.2020 00:00;51;23;28;Sonnig;12;12;0
02.06.2020 01:00;20;8;12;Sonnig;12;11;0
02.06.2020 02:00;17;6;11;Sonnig;11;11;0
02.06.2020 03:00;9;5;4;Sonnig;10;10;0
02.06.2020 04:00;11;8;3;Sonnig;11;11;0
02.06.2020 05:00;46;27;19;Leicht bewölkt;12;12;0
02.06.2020 06:00;173;113;60;Leicht bewölkt;13;13;0
02.06.2020 07:00;401;233;168;Leicht bewölkt;15;15;0
02.06.2020 08:00;539;336;203;Leicht bewölkt;17;17;0
02.06.2020 09:00;533;338;195;Leicht bewölkt;18;18;0
02.06.2020 10:00;605;312;293;Leicht bewölkt;19;19;0
02.06.2020 11:00;718;364;354;Leicht bewölkt;20;20;0
02.06.2020 12:00;728;369;359;Leicht bewölkt;21;21;0
02.06.2020 13:00;733;373;360;Leicht bewölkt;22;22;0
02.06.2020 14:00;766;371;395;Leicht bewölkt;22;22;0
02.06.2020 15:00;840;438;402;Leicht bewölkt;22;25;0
02.06.2020 16:00;879;386;493;Leicht bewölkt;21;21;0
02.06.2020 17:00;996;479;517;Stellenweiser Regenfall;20;20;1
02.06.2020 18:00;951;435;516;Stellenweiser Regenfall;19;19;1
02.06.2020 19:00;720;315;405;Stellenweiser Regenfall;18;18;0
02.06.2020 20:00;459;215;244;Stellenweiser Regenfall;17;17;0
02.06.2020 21:00;429;192;237;Stellenweiser Regenfall;15;15;0
02.06.2020 22:00;233;88;145;Stellenweiser Regenfall;14;14;0
02.06.2020 23:00;142;42;100;Sonnig;12;13;0
03.06.2020 00:00;90;26;64;Sonnig;11;11;0
03.06.2020 01:00;52;30;22;Sonnig;11;11;0
03.06.2020 02:00;12;2;10;Bewölkt;10;10;0
03.06.2020 03:00;13;5;8;Bewölkt;10;10;0
03.06.2020 04:00;16;9;7;Bewölkt;11;11;0
03.06.2020 05:00;54;30;24;Leicht bewölkt;12;12;0
03.06.2020 06:00;176;109;67;Leicht bewölkt;13;13;0
03.06.2020 07:00;384;206;178;Leicht bewölkt;15;15;0
03.06.2020 08:00;547;328;219;Leicht bewölkt;17;17;0
03.06.2020 09:00;488;296;192;Leicht bewölkt;19;19;0
03.06.2020 10:00;528;281;247;Leicht bewölkt;20;20;0
03.06.2020 11:00;689;360;329;Stellenweiser Regenfall;21;21;0
03.06.2020 12:00;770;378;392;Stellenweiser Regenfall;23;25;0
03.06.2020 13:00;790;388;402;Stellenweiser Regenfall;23;25;0
03.06.2020 14:00;872;448;424;Leicht bewölkt;23;25;0
03.06.2020 15:00;730;341;389;Leicht bewölkt;24;25;0
03.06.2020 16:00;863;445;418;Leicht bewölkt;23;24;0
03.06.2020 17:00;910;468;442;Stellenweise Gewitter und Niederschläge;22;24;3
03.06.2020 18:00;911;400;511;Stellenweise Gewitter und Niederschläge;21;21;4
03.06.2020 19:00;645;277;368;Stellenweise Gewitter und Niederschläge;20;20;2
03.06.2020 20:00;488;223;265;Nieselregen mit Gewitter;19;19;1
03.06.2020 21:00;310;127;183;Nieselregen mit Gewitter;18;18;14
03.06.2020 22:00;242;99;143;Nieselregen mit Gewitter;17;16;7
03.06.2020 23:00;121;62;59;Mäßiger bis starker Regenschauer;15;15;14
04.06.2020 00:00;82;33;49;Mäßiger bis starker Regenschauer;14;14;28
04.06.2020 01:00;43;28;15;Mäßiger bis starker Regenschauer;13;13;14
04.06.2020 02:00;22;11;11;Mäßiger bis starker Regenschauer;12;12;5
04.06.2020 03:00;17;5;12;Mäßiger bis starker Regenschauer;12;11;7
04.06.2020 04:00;8;7;1;Mäßiger bis starker Regenschauer;12;11;4
04.06.2020 05:00;35;17;18;Stellenweiser Nieselregen;12;12;0
04.06.2020 06:00;108;65;43;Stellenweiser Nieselregen;12;12;0
04.06.2020 07:00;249;134;115;Stellenweiser Nieselregen;13;12;0
04.06.2020 08:00;351;236;115;Bedeckt;13;13;1
04.06.2020 09:00;294;181;113;Bedeckt;14;13;1
04.06.2020 10:00;261;141;120;Bedeckt;14;13;1
04.06.2020 11:00;320;161;159;Nieselregen;14;13;5
04.06.2020 12:00;318;146;172;Nieselregen;14;13;6
04.06.2020 13:00;387;210;177;Nieselregen;14;13;3
04.06.2020 14:00;329;157;172;Leichter Regenfall;14;13;9
04.06.2020 15:00;319;159;160;Leichter Regenfall;14;14;12
04.06.2020 16:00;335;155;180;Leichter Regenfall;14;13;6
04.06.2020 17:00;366;170;196;Mäßiger Regenfall;14;13;1
04.06.2020 18:00;387;143;244;Mäßiger Regenfall;13;12;13
04.06.2020 19:00;252;105;147;Mäßiger Regenfall;13;12;6
04.06.2020 20:00;195;92;103;Teilweise mäßiger Regenfall;12;11;4
04.06.2020 21:00;138;74;64;Teilweise mäßiger Regenfall;12;11;5
04.06.2020 22:00;77;24;53;Teilweise mäßiger Regenfall;12;11;3
04.06.2020 23:00;69;35;34;Nieselregen;11;11;0
05.06.2020 00:00;49;25;24;Nieselregen;11;10;1
05.06.2020 01:00;27;12;15;Nieselregen;11;10;0
05.06.2020 02:00;17;11;6;Bewölkt;11;10;2
05.06.2020 03:00;7;5;2;Bewölkt;11;10;2
05.06.2020 04:00;9;7;2;Bewölkt;11;10;1
05.06.2020 05:00;35;19;16;Leichter Regenfall;11;10;4
05.06.2020 06:00;103;61;42;Leichter Regenfall;11;10;6
05.06.2020 07:00;263;154;109;Leichter Regenfall;11;10;3
05.06.2020 08:00;427;272;155;Stellenweiser leichter Regenfall;12;11;5
05.06.2020 09:00;400;260;140;Stellenweiser leichter Regenfall;12;11;7
05.06.2020 10:00;397;235;162;Stellenweiser leichter Regenfall;13;11;3
05.06.2020 11:00;395;188;207;Leichter Regenschauer;14;12;6
05.06.2020 12:00;479;235;244;Leichter Regenschauer;14;12;8
05.06.2020 13:00;488;234;254;Leichter Regenschauer;15;14;4
05.06.2020 14:00;497;258;239;Leichter Regenschauer;16;15;3
05.06.2020 15:00;559;284;275;Leichter Regenschauer;16;16;4
05.06.2020 16:00;615;273;342;Leichter Regenschauer;16;15;2
05.06.2020 17:00;548;225;323;Leichter Regenschauer;15;14;0
05.06.2020 18:00;460;217;243;Leichter Regenschauer;15;14;0
05.06.2020 19:00;397;177;220;Leichter Regenschauer;14;13;0
05.06.2020 20:00;286;142;144;Bewölkt;13;12;1
05.06.2020 21:00;170;88;82;Bewölkt;12;11;1
05.06.2020 22:00;122;59;63;Bewölkt;12;11;0
05.06.2020 23:00;129;63;66;Nieselregen;12;11;0
06.06.2020 00:00;89;38;51;Nieselregen;12;11;1
06.06.2020 01:00;79;34;45;Nieselregen;12;11;0
06.06.2020 02:00;44;23;21;Bewölkt;12;11;0
06.06.2020 03:00;24;11;13;Bewölkt;12;11;0
06.06.2020 04:00;23;15;8;Bewölkt;12;11;0
06.06.2020 05:00;20;8;12;Stellenweiser Nieselregen;12;11;0
06.06.2020 06:00;44;25;19;Stellenweiser Nieselregen;13;12;0
06.06.2020 07:00;61;22;39;Stellenweiser Nieselregen;14;13;0
06.06.2020 08:00;141;79;62;Leicht bewölkt;14;14;0
06.06.2020 09:00;262;160;102;Leicht bewölkt;15;15;0
06.06.2020 10:00;355;201;154;Leicht bewölkt;16;16;0
06.06.2020 11:00;470;250;220;Stellenweiser Regenfall;17;17;0
06.06.2020 12:00;539;288;251;Stellenweiser Regenfall;18;18;0
06.06.2020 13:00;554;282;272;Stellenweiser Regenfall;18;18;0
06.06.2020 14:00;617;281;336;Bewölkt;18;18;1
06.06.2020 15:00;764;476;288;Bewölkt;18;18;1
06.06.2020 16:00;620;368;252;Bewölkt;17;17;0
06.06.2020 17:00;668;236;432;Stellenweiser Regenfall;17;17;2
06.06.2020 18:00;470;163;307;Stellenweiser Regenfall;16;16;3
06.06.2020 19:00;379;140;239;Stellenweiser Regenfall;15;15;1
06.06.2020 20:00;253;117;136;Leichter Regenfall;14;14;5
06.06.2020 21:00;168;80;88;Leichter Regenfall;13;13;7
06.06.2020 22:00;128;62;66;Leichter Regenfall;13;13;4
06.06.2020 23:00;109;58;51;Leichter Regenfall;12;12;12
07.06.2020 00:00;107;55;52;Leichter Regenfall;12;12;25
07.06.2020 01:00;95;58;37;Leichter Regenfall;12;12;12
07.06.2020 02:00;64;18;46;Mäßiger Regenfall;12;12;6
07.06.2020 03:00;37;16;21;Mäßiger Regenfall;12;12;8
07.06.2020 04:00;15;3;12;Mäßiger Regenfall;12;12;4
07.06.2020 05:00;10;4;6;Nieselregen;11;12;5
07.06.2020 06:00;21;14;7;Nieselregen;11;11;7
07.06.2020 07:00;19;6;13;Nieselregen;11;11;4
07.06.2020 08:00;33;18;15;Leichter Regenfall;11;11;16
07.06.2020 09:00;59;30;29;Leichter Regenfall;11;10;21
07.06.2020 10:00;90;41;49;Leichter Regenfall;11;10;1
07.06.2020 11:00;78;44;34;Mäßiger Regenfall;11;11;24
07.06.2020 12:00;101;51;50;Mäßiger Regenfall;11;11;32
07.06.2020 13:00;116;60;56;Mäßiger Regenfall;11;11;16
07.06.2020 14:00;109;49;60;Starker Regenfall;11;11;17
07.06.2020 15:00;117;53;64;Starker Regenfall;11;11;22
07.06.2020 16:00;159;76;83;Starker Regenfall;10;10;11
07.06.2020 17:00;152;72;80;Mäßiger Regenfall;10;10;8
07.06.2020 18:00;279;142;137;Mäßiger Regenfall;9;9;1
07.06.2020 19:00;226;101;125;Mäßiger Regenfall;9;9;5
07.06.2020 20:00;195;104;91;Stellenweiser leichter Regenfall;8;8;2
07.06.2020 21:00;123;58;65;Stellenweiser leichter Regenfall;8;8;2
07.06.2020 22:00;97;50;47;Stellenweiser leichter Regenfall;7;7;1
07.06.2020 23:00;62;30;32;Leicht bewölkt;7;7;0
08.06.2020 00:00;29;18;11;Leicht bewölkt;7;7;0
08.06.2020 01:00;17;13;4;Leicht bewölkt;6;6;0
08.06.2020 02:00;11;9;2;Leicht bewölkt;6;6;0
08.06.2020 03:00;15;6;9;Leicht bewölkt;6;6;0
08.06.2020 04:00;7;6;1;Leicht bewölkt;6;6;0
08.06.2020 05:00;41;25;16;Leicht bewölkt;7;7;0
08.06.2020 06:00;136;87;49;Leicht bewölkt;8;8;0
08.06.2020 07:00;378;229;149;Leicht bewölkt;10;10;0
08.06.2020 08:00;447;275;172;Leicht bewölkt;11;11;0
08.06.2020 09:00;444;253;191;Leicht bewölkt;13;13;0
08.06.2020 10:00;480;276;204;Leicht bewölkt;14;14;0
08.06.2020 11:00;553;290;263;Bedeckt;15;15;0
08.06.2020 12:00;593;303;290;Bedeckt;16;16;0
08.06.2020 13:00;590;283;307;Bedeckt;17;16;0
08.06.2020 14:00;706;353;353;Leicht bewölkt;17;17;0
08.06.2020 15:00;742;386;356;Leicht bewölkt;17;17;0
08.06.2020 16:00;791;407;384;Leicht bewölkt;16;16;0
08.06.2020 17:00;912;410;502;Stellenweiser Regenfall;15;15;1
08.06.2020 18:00;729;325;404;Stellenweiser Regenfall;15;14;2
08.06.2020 19:00;487;225;262;Stellenweiser Regenfall;14;13;1
08.06.2020 20:00;375;173;202;Nieselregen;13;12;1
08.06.2020 21:00;190;91;99;Nieselregen;12;10;1
08.06.2020 22:00;112;50;62;Nieselregen;11;10;0
08.06.2020 23:00;94;47;47;Stellenweiser Regenfall;11;10;0
09.06.2020 00:00;64;33;31;Stellenweiser Regenfall;11;10;1
09.06.2020 01:00;44;19;25;Stellenweiser Regenfall;11;10;0
09.06.2020 02:00;18;8;10;Stellenweiser Regenfall;11;9;3
09.06.2020 03:00;6;0;6;Stellenweiser Regenfall;10;9;4
09.06.2020 04:00;10;8;2;Stellenweiser Regenfall;11;10;2
09.06.2020 05:00;32;24;8;Leichter Regenfall;11;10;4
09.06.2020 06:00;111;68;43;Leichter Regenfall;11;10;5
09.06.2020 07:00;291;176;115;Leichter Regenfall;11;10;3
09.06.2020 08:00;371;238;133;Leichter Regenfall;12;10;2
09.06.2020 09:00;313;189;124;Leichter Regenfall;12;11;3
09.06.2020 10:00;343;184;159;Leichter Regenfall;12;11;2
09.06.2020 11:00;318;150;168;Nieselregen;12;11;1
09.06.2020 12:00;408;198;210;Nieselregen;13;12;1
09.06.2020 13:00;437;214;223;Nieselregen;13;12;0
09.06.2020 14:00;486;259;227;Bedeckt;13;12;1
09.06.2020 15:00;552;286;266;Bedeckt;13;12;1
09.06.2020 16:00;627;309;318;Bedeckt;13;12;1
09.06.2020 17:00;731;347;384;Leichter Regenschauer;13;13;0
09.06.2020 18:00;686;295;391;Leichter Regenschauer;13;13;0
09.06.2020 19:00;484;212;272;Leichter Regenschauer;13;12;0
09.06.2020 20:00;262;101;161;Bewölkt;13;12;0
09.06.2020 21:00;162;80;82;Bewölkt;12;12;0
09.06.2020 22:00;143;61;82;Bewölkt;12;12;0
09.06.2020 23:00;95;42;53;Leichter Nebel;12;11;0
10.06.2020 00:00;79;41;38;Leichter Nebel;12;11;0
10.06.2020 01:00;33;9;24;Leichter Nebel;12;11;0
10.06.2020 02:00;12;7;5;Nebel;12;11;1
10.06.2020 03:00;8;1;7;Nebel;12;11;1
10.06.2020 04:00;10;5;5;Nebel;12;11;1
10.06.2020 05:00;41;23;18;Leichter Regenschauer;12;11;2
10.06.2020 06:00;126;76;50;Leichter Regenschauer;12;12;2
10.06.2020 07:00;287;161;126;Leichter Regenschauer;12;12;1
10.06.2020 08:00;427;265;162;Leichter Regenschauer;13;12;2
10.06.2020 09:00;383;224;159;Leichter Regenschauer;13;13;3
10.06.2020 10:00;429;237;192;Leichter Regenschauer;13;14;2
10.06.2020 11:00;448;244;204;Leichter Regenschauer;14;14;6
10.06.2020 12:00;569;265;304;Leichter Regenschauer;14;15;8
10.06.2020 13:00;531;261;270;Leichter Regenschauer;14;15;4
10.06.2020 14:00;600;299;301;Leichter Regenschauer;15;15;6
10.06.2020 15:00;598;319;279;Leichter Regenschauer;15;15;8
10.06.2020 16:00;714;346;368;Leichter Regenschauer;15;15;4
10.06.2020 17:00;796;383;413;Leichter Regenschauer;14;15;9
10.06.2020 18:00;686;287;399;Leichter Regenschauer;14;15;12
10.06.2020 19:00;488;209;279;Leichter Regenschauer;14;14;6
10.06.2020 20:00;348;157;191;Mäßiger bis starker Regenschauer;13;14;5
10.06.2020 21:00;190;111;79;Mäßiger bis starker Regenschauer;13;13;6
10.06.2020 22:00;167;78;89;Mäßiger bis starker Regenschauer;12;12;3
10.06.2020 23:00;121;65;56;Leichter Regenschauer;12;12;9
11.06.2020 00:00;108;37;71;Leichter Regenschauer;11;11;17
11.06.2020 01:00;84;46;38;Leichter Regenschauer;11;11;9
11.06.2020 02:00;42;20;22;Mäßiger Regenfall;11;11;6
11.06.2020 03:00;26;14;12;Mäßiger Regenfall;11;11;8
11.06.2020 04:00;13;8;5;Mäßiger Regenfall;12;12;4
11.06.2020 05:00;23;15;8;Leichter Regenschauer;12;12;1
11.06.2020 06:00;64;53;11;Leichter Regenschauer;12;12;1
11.06.2020 07:00;89;70;19;Leichter Regenschauer;13;13;1
11.06.2020 08:00;106;45;61;Leichter Nebel;13;14;2
11.06.2020 09:00;171;90;81;Leichter Nebel;14;14;2
11.06.2020 10:00;206;96;110;Leichter Nebel;15;15;1
11.06.2020 11:00;294;140;154;Leichter Regenschauer;16;16;2
11.06.2020 12:00;442;223;219;Leichter Regenschauer;17;17;2
11.06.2020 13:00;468;200;268;Leichter Regenschauer;18;18;1
11.06.2020 14:00;559;271;288;Leichter Regenschauer;18;18;0
11.06.2020 15:00;534;296;238;Leichter Regenschauer;19;19;0
11.06.2020 16:00;591;315;276;Leichter Regenschauer;19;19;0
11.06.2020 17:00;585;285;300;Leicht bewölkt;18;18;0
11.06.2020 18:00;602;317;285;Leicht bewölkt;18;18;0
11.06.2020 19:00;558;293;265;Leicht bewölkt;17;17;0
11.06.2020 20:00;410;187;223;Leicht bewölkt;16;16;0
11.06.2020 21:00;337;161;176;Leicht bewölkt;15;15;0
11.06.2020 22:00;199;83;116;Leicht bewölkt;13;13;0
11.06.2020 23:00;151;60;91;Leicht bewölkt;12;12;0
12.06.2020 00:00;96;42;54;Leicht bewölkt;11;11;0
12.06.2020 01:00;47;23;24;Leicht bewölkt;10;10;0
12.06.2020 02:00;19;6;13;Leicht bewölkt;10;10;0
12.06.2020 03:00;11;3;8;Leicht bewölkt;9;9;0
12.06.2020 04:00;8;6;2;Leicht bewölkt;10;11;0
12.06.2020 05:00;45;31;14;Leicht bewölkt;12;12;0
12.06.2020 06:00;130;91;39;Leicht bewölkt;13;13;0
12.06.2020 07:00;269;172;97;Leicht bewölkt;15;15;0
12.06.2020 08:00;398;245;153;Leicht bewölkt;17;18;0
12.06.2020 09:00;609;372;237;Leicht bewölkt;19;20;0
12.06.2020 10:00;781;465;316;Leicht bewölkt;21;21;0
12.06.2020 11:00;851;463;388;Leicht bewölkt;22;24;0
12.06.2020 12:00;884;430;454;Leicht bewölkt;24;25;0
12.06.2020 13:00;850;422;428;Leicht bewölkt;24;25;0
12.06.2020 14:00;947;485;462;Leicht bewölkt;24;25;0
12.06.2020 15:00;955;472;483;Leicht bewölkt;24;25;0
12.06.2020 16:00;896;430;466;Leicht bewölkt;23;24;0
12.06.2020 17:00;1099;545;554;Leicht bewölkt;22;23;0
12.06.2020 18:00;872;397;475;Leicht bewölkt;21;21;0
12.06.2020 19:00;784;375;409;Leicht bewölkt;20;20;0
12.06.2020 20:00;656;315;341;Leicht bewölkt;19;19;0
12.06.2020 21:00;505;215;290;Leicht bewölkt;17;17;0
12.06.2020 22:00;315;128;187;Leicht bewölkt;16;16;0
12.06.2020 23:00;309;125;184;Leicht bewölkt;15;15;0
13.06.2020 00:00;233;115;118;Leicht bewölkt;13;13;0
13.06.2020 01:00;130;63;67;Leicht bewölkt;13;12;0
13.06.2020 02:00;76;32;44;Leicht bewölkt;12;12;0
13.06.2020 03:00;59;35;24;Leicht bewölkt;11;11;0
13.06.2020 04:00;39;25;14;Leicht bewölkt;12;12;0
13.06.2020 05:00;38;22;16;Leicht bewölkt;12;13;0
13.06.2020 06:00;42;27;15;Leicht bewölkt;13;14;0
13.06.2020 07:00;103;39;64;Leicht bewölkt;14;15;0
13.06.2020 08:00;191;97;94;Leicht bewölkt;16;16;0
13.06.2020 09:00;344;216;128;Leicht bewölkt;17;17;0
13.06.2020 10:00;516;268;248;Leicht bewölkt;18;18;0
13.06.2020 11:00;732;404;328;Leicht bewölkt;20;20;0
13.06.2020 12:00;747;384;363;Leicht bewölkt;21;21;0
13.06.2020 13:00;734;373;361;Leicht bewölkt;21;21;0
13.06.2020 14:00;811;357;454;Leicht bewölkt;22;22;1
13.06.2020 15:00;881;444;437;Leicht bewölkt;22;25;2
13.06.2020 16:00;748;390;358;Leicht bewölkt;22;22;1
13.06.2020 17:00;728;308;420;Stellenweiser Regenfall;21;21;1
13.06.2020 18:00;723;324;399;Stellenweiser Regenfall;20;20;1
13.06.2020 19:00;573;250;323;Stellenweiser Regenfall;19;19;0
13.06.2020 20:00;183;92;91;Leicht bewölkt;17;17;2
13.06.2020 21:00;165;80;85;Leicht bewölkt;16;15;2
13.06.2020 22:00;99;42;57;Leicht bewölkt;15;14;1
13.06.2020 23:00;81;39;42;Nieselregen;13;12;14
14.06.2020 00:00;112;48;64;Nieselregen;12;11;27
14.06.2020 01:00;58;28;30;Nieselregen;12;10;14
14.06.2020 02:00;36;9;27;Mäßiger Regenfall;12;10;2
14.06.2020 03:00;20;8;12;Mäßiger Regenfall;12;10;26
14.06.2020 04:00;17;8;9;Mäßiger Regenfall;12;10;13
14.06.2020 05:00;15;6;9;Mäßiger Regenfall;12;10;22
14.06.2020 06:00;20;13;7;Mäßiger Regenfall;12;11;29
14.06.2020 07:00;15;7;8;Mäßiger Regenfall;12;11;15
14.06.2020 08:00;45;26;19;Mäßiger Regenfall;13;11;11
14.06.2020 09:00;81;54;27;Mäßiger Regenfall;13;11;15
14.06.2020 10:00;99;47;52;Mäßiger Regenfall;13;11;8
14.06.2020 11:00;131;68;63;Leichter Regenfall;13;12;7
14.06.2020 12:00;151;69;82;Leichter Regenfall;13;12;1
14.06.2020 13:00;212;103;109;Leichter Regenfall;13;12;5
14.06.2020 14:00;226;106;120;Mäßiger Regenfall;13;12;1
14.06.2020 15:00;229;120;109;Mäßiger Regenfall;13;12;14
14.06.2020 16:00;252;123;129;Mäßiger Regenfall;13;12;7
14.06.2020 17:00;262;132;130;Teilweise mäßiger Regenfall;13;12;7
14.06.2020 18:00;257;131;126;Teilweise mäßiger Regenfall;13;13;1
14.06.2020 19:00;230;104;126;Teilweise mäßiger Regenfall;13;12;5
14.06.2020 20:00;196;104;92;Leichter Regenfall;13;12;6
14.06.2020 21:00;106;43;63;Leichter Regenfall;13;12;8
14.06.2020 22:00;88;33;55;Leichter Regenfall;12;12;4
14.06.2020 23:00;50;25;25;Leichter Regenfall;12;12;1
15.06.2020 00:00;29;17;12;Leichter Regenfall;12;12;2
15.06.2020 01:00;17;6;11;Leichter Regenfall;12;12;1
15.06.2020 02:00;10;9;1;Mäßiger Regenfall;12;12;5
15.06.2020 03:00;4;2;2;Mäßiger Regenfall;12;12;6
15.06.2020 04:00;12;8;4;Mäßiger Regenfall;13;13;3
15.06.2020 05:00;40;27;13;Nieselregen;13;13;0
15.06.2020 06:00;170;102;68;Nieselregen;13;13;0
15.06.2020 07:00;590;381;209;Nieselregen;14;14;0
15.06.2020 08:00;583;337;246;Bedeckt;14;14;0
15.06.2020 09:00;554;335;219;Bedeckt;15;15;0
15.06.2020 10:00;567;283;284;Bedeckt;15;15;0
15.06.2020 11:00;594;312;282;Stellenweiser Regenfall;15;15;0
15.06.2020 12:00;661;351;310;Stellenweiser Regenfall;16;16;0
15.06.2020 13:00;857;394;463;Stellenweiser Regenfall;15;15;0
15.06.2020 14:00;736;394;342;Bewölkt;15;15;1
15.06.2020 15:00;822;400;422;Bewölkt;15;15;1
15.06.2020 16:00;865;417;448;Bewölkt;15;15;1
15.06.2020 17:00;911;413;498;Nieselregen;15;15;0
15.06.2020 18:00;714;315;399;Nieselregen;15;15;0
15.06.2020 19:00;506;223;283;Nieselregen;14;15;0
15.06.2020 20:00;375;158;217;Bedeckt;14;14;0
15.06.2020 21:00;211;89;122;Bedeckt;14;14;0
15.06.2020 22:00;144;65;79;Bedeckt;14;14;0
15.06.2020 23:00;79;30;49;Stellenweiser Regenfall;13;14;0
16.06.2020 00:00;44;17;27;Stellenweiser Regenfall;13;13;0
16.06.2020 01:00;21;16;5;Stellenweiser Regenfall;13;13;0
16.06.2020 02:00;18;10;8;Bedeckt;13;13;0
16.06.2020 03:00;12;6;6;Bedeckt;13;13;0
16.06.2020 04:00;15;10;5;Bedeckt;13;13;0
16.06.2020 05:00;39;24;15;Stellenweiser Nieselregen;13;13;3
16.06.2020 06:00;131;78;53;Stellenweiser Nieselregen;13;13;4
16.06.2020 07:00;630;410;220;Stellenweiser Nieselregen;13;13;2
16.06.2020 08:00;586;341;245;Leichter Regenfall;13;13;3
16.06.2020 09:00;508;312;196;Leichter Regenfall;14;14;4
16.06.2020 10:00;569;344;225;Leichter Regenfall;14;14;2
16.06.2020 11:00;616;312;304;Nieselregen;15;15;2
16.06.2020 12:00;608;291;317;Nieselregen;16;16;2
16.06.2020 13:00;713;358;355;Nieselregen;17;17;1
16.06.2020 14:00;677;314;363;Stellenweiser Nieselregen;18;18;1
16.06.2020 15:00;686;301;385;Stellenweiser Nieselregen;19;19;1
16.06.2020 16:00;792;422;370;Stellenweiser Nieselregen;19;19;0
16.06.2020 17:00;916;416;500;Stellenweiser Regenfall;18;18;0
16.06.2020 18:00;821;366;455;Stellenweiser Regenfall;18;18;0
16.06.2020 19:00;625;299;326;Stellenweiser Regenfall;17;17;0
16.06.2020 20:00;448;197;251;Leicht bewölkt;16;16;0
16.06.2020 21:00;306;132;174;Leicht bewölkt;15;15;0
16.06.2020 22:00;255;121;134;Leicht bewölkt;14;14;0
16.06.2020 23:00;172;57;115;Leicht bewölkt;13;13;0
17.06.2020 00:00;94;38;56;Leicht bewölkt;12;12;0
17.06.2020 01:00;53;18;35;Leicht bewölkt;12;12;0
17.06.2020 02:00;31;13;18;Leichter Nebel;11;11;0
17.06.2020 03:00;12;4;8;Leichter Nebel;11;11;0
17.06.2020 04:00;13;11;2;Leichter Nebel;11;11;0
17.06.2020 05:00;53;33;20;Leichter Nebel;12;12;0
17.06.2020 06:00;175;106;69;Leichter Nebel;13;13;0
17.06.2020 07:00;606;377;229;Leichter Nebel;14;14;0
17.06.2020 08:00;621;363;258;Bedeckt;15;15;0
17.06.2020 09:00;591;332;259;Bedeckt;16;16;0
17.06.2020 10:00;528;279;249;Bedeckt;16;16;0
17.06.2020 11:00;605;310;295;Leichter Regenschauer;16;15;0
17.06.2020 12:00;487;243;244;Leichter Regenschauer;15;14;0
17.06.2020 13:00;563;229;334;Leichter Regenschauer;15;14;0
17.06.2020 14:00;455;221;234;Bedeckt;14;13;2
17.06.2020 15:00;547;244;303;Bedeckt;14;12;2
17.06.2020 16:00;603;298;305;Bedeckt;13;12;1
17.06.2020 17:00;787;369;418;Leichter Regenfall;13;12;1
17.06.2020 18:00;698;305;393;Leichter Regenfall;13;13;1
17.06.2020 19:00;501;249;252;Leichter Regenfall;13;13;1
17.06.2020 20:00;389;184;205;Leicht bewölkt;12;13;0
17.06.2020 21:00;261;98;163;Leicht bewölkt;12;13;0
17.06.2020 22:00;209;88;121;Leicht bewölkt;12;12;0
17.06.2020 23:00;107;46;61;Bedeckt;12;12;0
18.06.2020 00:00;86;28;58;Bedeckt;12;12;0
18.06.2020 01:00;43;22;21;Bedeckt;11;11;0
18.06.2020 02:00;12;7;5;Bewölkt;11;11;0
18.06.2020 03:00;6;2;4;Bewölkt;10;10;0
18.06.2020 04:00;20;13;7;Bewölkt;11;11;0
18.06.2020 05:00;53;29;24;Leicht bewölkt;12;12;0
18.06.2020 06:00;158;96;62;Leicht bewölkt;12;13;0
18.06.2020 07:00;685;442;243;Leicht bewölkt;14;14;0
18.06.2020 08:00;640;390;250;Leicht bewölkt;15;16;0
18.06.2020 09:00;584;355;229;Leicht bewölkt;17;17;0
18.06.2020 10:00;610;337;273;Leicht bewölkt;18;18;0
18.06.2020 11:00;676;347;329;Leicht bewölkt;19;19;0
18.06.2020 12:00;795;387;408;Leicht bewölkt;21;21;0
18.06.2020 13:00;992;459;533;Leicht bewölkt;21;21;0
18.06.2020 14:00;863;423;440;Leicht bewölkt;21;21;1
18.06.2020 15:00;985;434;551;Leicht bewölkt;21;21;1
18.06.2020 16:00;973;456;517;Leicht bewölkt;20;20;0
18.06.2020 17:00;1153;543;610;Stellenweiser Regenfall;19;19;3
18.06.2020 18:00;1047;444;603;Stellenweiser Regenfall;18;18;4
18.06.2020 19:00;820;345;475;Stellenweiser Regenfall;17;17;2
18.06.2020 20:00;359;168;191;Leichter Regenschauer;16;16;3
18.06.2020 21:00;257;111;146;Leichter Regenschauer;14;14;4
18.06.2020 22:00;201;81;120;Leichter Regenschauer;13;13;2
18.06.2020 23:00;152;59;93;Leichter Regenschauer;12;12;2
19.06.2020 00:00;79;32;47;Leichter Regenschauer;11;11;5
19.06.2020 01:00;40;12;28;Leichter Regenschauer;11;11;2
19.06.2020 02:00;19;7;12;Stellenweiser Regenfall;11;10;3
19.06.2020 03:00;10;5;5;Stellenweiser Regenfall;10;10;4
19.06.2020 04:00;14;9;5;Stellenweiser Regenfall;11;10;2
19.06.2020 05:00;47;34;13;Leichter Regenfall;11;11;3
19.06.2020 06:00;161;93;68;Leichter Regenfall;12;12;4
19.06.2020 07:00;623;368;255;Leichter Regenfall;12;12;2
19.06.2020 08:00;586;338;248;Leichter Regenfall;13;13;4
19.06.2020 09:00;631;381;250;Leichter Regenfall;13;13;5
19.06.2020 10:00;665;357;308;Leichter Regenfall;14;13;3
19.06.2020 11:00;704;359;345;Leichter Regenfall;14;14;3
19.06.2020 12:00;698;321;377;Leichter Regenfall;14;14;4
19.06.2020 13:00;622;258;364;Leichter Regenfall;15;15;2
19.06.2020 14:00;383;162;221;Stellenweiser Nieselregen;17;16;1
19.06.2020 15:00;374;138;236;Stellenweiser Nieselregen;18;18;1
19.06.2020 16:00;467;231;236;Stellenweiser Nieselregen;18;18;0
19.06.2020 17:00;647;320;327;Leicht bewölkt;18;18;0
19.06.2020 18:00;629;280;349;Leicht bewölkt;18;18;0
19.06.2020 19:00;565;257;308;Leicht bewölkt;17;17;0
19.06.2020 20:00;440;225;215;Leicht bewölkt;16;16;0
19.06.2020 21:00;282;146;136;Leicht bewölkt;15;15;0
19.06.2020 22:00;235;97;138;Leicht bewölkt;14;14;0
19.06.2020 23:00;177;59;118;Stellenweiser Regenfall;12;13;0
20.06.2020 00:00;171;75;96;Stellenweiser Regenfall;11;11;0
20.06.2020 01:00;88;32;56;Stellenweiser Regenfall;10;10;0
20.06.2020 02:00;48;24;24;Leicht bewölkt;10;10;0
20.06.2020 03:00;38;14;24;Leicht bewölkt;9;9;0
20.06.2020 04:00;26;13;13;Leicht bewölkt;10;10;0
20.06.2020 05:00;35;18;17;Leicht bewölkt;11;11;0
20.06.2020 06:00;46;27;19;Leicht bewölkt;12;12;0
20.06.2020 07:00;101;50;51;Leicht bewölkt;14;14;0
20.06.2020 08:00;209;107;102;Leicht bewölkt;16;16;0
20.06.2020 09:00;420;267;153;Leicht bewölkt;18;18;0
20.06.2020 10:00;606;360;246;Leicht bewölkt;19;19;0
20.06.2020 11:00;705;398;307;Leicht bewölkt;20;20;0
20.06.2020 12:00;799;441;358;Leicht bewölkt;22;22;0
20.06.2020 13:00;833;444;389;Leicht bewölkt;21;21;0
20.06.2020 14:00;894;449;445;Leicht bewölkt;21;21;2
20.06.2020 15:00;873;412;461;Leicht bewölkt;21;21;3
20.06.2020 16:00;706;316;390;Leicht bewölkt;20;20;2
20.06.2020 17:00;715;317;398;Stellenweiser Regenfall;19;19;1
20.06.2020 18:00;705;301;404;Stellenweiser Regenfall;18;18;1
20.06.2020 19:00;566;251;315;Stellenweiser Regenfall;17;17;1
20.06.2020 20:00;444;203;241;Leicht bewölkt;16;16;2
20.06.2020 21:00;307;153;154;Leicht bewölkt;14;14;2
20.06.2020 22:00;255;96;159;Leicht bewölkt;13;13;1
20.06.2020 23:00;207;88;119;Leichter Regenschauer;12;12;2
21.06.2020 00:00;202;73;129;Leichter Regenschauer;11;11;5
21.06.2020 01:00;157;69;88;Leichter Regenschauer;11;11;2
21.06.2020 02:00;91;24;67;Stellenweiser Regenfall;10;10;1
21.06.2020 03:00;61;19;42;Stellenweiser Regenfall;10;10;1
21.06.2020 04:00;28;13;15;Stellenweiser Regenfall;11;11;0
21.06.2020 05:00;27;11;16;Leicht bewölkt;12;12;0
21.06.2020 06:00;30;22;8;Leicht bewölkt;13;13;0
21.06.2020 07:00;62;34;28;Leicht bewölkt;15;15;0
21.06.2020 08:00;107;59;48;Leicht bewölkt;16;16;1
21.06.2020 09:00;314;182;132;Leicht bewölkt;18;18;1
21.06.2020 10:00;395;207;188;Leicht bewölkt;20;20;0
21.06.2020 11:00;480;257;223;Stellenweiser Regenfall;21;21;2
21.06.2020 12:00;598;308;290;Stellenweiser Regenfall;22;23;3
21.06.2020 13:00;664;362;302;Stellenweiser Regenfall;22;23;1
21.06.2020 14:00;721;381;340;Stellenweiser Regenfall;22;22;2
21.06.2020 15:00;729;363;366;Stellenweiser Regenfall;22;22;3
21.06.2020 16:00;730;329;401;Stellenweiser Regenfall;21;21;2
21.06.2020 17:00;688;283;405;Stellenweiser Regenfall;20;20;3
21.06.2020 18:00;578;289;289;Stellenweiser Regenfall;20;20;4
21.06.2020 19:00;506;238;268;Stellenweiser Regenfall;19;19;2
21.06.2020 20:00;410;210;200;Stellenweiser Regenfall;18;18;1
21.06.2020 21:00;294;128;166;Stellenweiser Regenfall;17;17;2
21.06.2020 22:00;217;103;114;Stellenweiser Regenfall;15;15;1
21.06.2020 23:00;114;40;74;Stellenweiser Regenfall;14;14;1
22.06.2020 00:00;61;21;40;Stellenweiser Regenfall;13;13;1
22.06.2020 01:00;19;7;12;Stellenweiser Regenfall;12;13;1
22.06.2020 02:00;10;6;4;Stellenweiser Regenfall;12;12;0
22.06.2020 03:00;2;2;0;Stellenweiser Regenfall;12;12;0
22.06.2020 04:00;5;3;2;Stellenweiser Regenfall;12;13;0
22.06.2020 05:00;57;34;23;Leicht bewölkt;13;13;0
22.06.2020 06:00;171;112;59;Leicht bewölkt;14;14;0
22.06.2020 07:00;634;393;241;Leicht bewölkt;14;14;0
22.06.2020 08:00;666;399;267;Nieselregen;15;15;4
22.06.2020 09:00;617;375;242;Nieselregen;15;15;5
22.06.2020 10:00;612;332;280;Nieselregen;17;17;2
22.06.2020 11:00;718;374;344;Leichter Regenfall;18;18;2
22.06.2020 12:00;707;355;352;Leichter Regenfall;19;19;2
22.06.2020 13:00;905;404;501;Leichter Regenfall;20;20;1
22.06.2020 14:00;805;411;394;Leicht bewölkt;22;22;0
22.06.2020 15:00;1023;499;524;Leicht bewölkt;23;24;0
22.06.2020 16:00;1011;476;535;Leicht bewölkt;22;23;0
22.06.2020 17:00;1153;486;667;Leicht bewölkt;22;23;0
22.06.2020 18:00;1062;450;612;Leicht bewölkt;22;22;0
22.06.2020 19:00;781;334;447;Leicht bewölkt;21;21;0
22.06.2020 20:00;488;242;246;Leicht bewölkt;20;20;0
22.06.2020 21:00;401;159;242;Leicht bewölkt;19;19;0
22.06.2020 22:00;279;118;161;Leicht bewölkt;17;17;0
22.06.2020 23:00;117;55;62;Leicht bewölkt;16;16;0
23.06.2020 00:00;79;32;47;Leicht bewölkt;15;15;0
23.06.2020 01:00;36;12;24;Leicht bewölkt;14;14;0
23.06.2020 02:00;7;5;2;Leichter Nebel;13;13;0
23.06.2020 03:00;10;2;8;Leichter Nebel;12;13;0
23.06.2020 04:00;12;7;5;Leichter Nebel;13;13;0
23.06.2020 05:00;61;35;26;Leichter Nebel;14;14;0
23.06.2020 06:00;190;114;76;Leichter Nebel;15;15;0
23.06.2020 07:00;783;485;298;Leichter Nebel;17;17;0
23.06.2020 08:00;797;491;306;Leicht bewölkt;18;18;0
23.06.2020 09:00;739;478;261;Leicht bewölkt;20;20;0
23.06.2020 10:00;751;410;341;Leicht bewölkt;21;21;0
23.06.2020 11:00;810;399;411;Leicht bewölkt;22;24;0
23.06.2020 12:00;856;416;440;Leicht bewölkt;23;25;0
23.06.2020 13:00;1076;515;561;Leicht bewölkt;23;25;0
23.06.2020 14:00;985;492;493;Leicht bewölkt;24;25;0
23.06.2020 15:00;1060;513;547;Leicht bewölkt;24;25;0
23.06.2020 16:00;1153;532;621;Leicht bewölkt;23;24;0
23.06.2020 17:00;1223;593;630;Leicht bewölkt;22;23;0
23.06.2020 18:00;1141;490;651;Leicht bewölkt;21;21;0
23.06.2020 19:00;881;385;496;Leicht bewölkt;20;20;0
23.06.2020 20:00;673;291;382;Leicht bewölkt;19;19;0
23.06.2020 21:00;508;198;310;Leicht bewölkt;18;18;0
23.06.2020 22:00;366;164;202;Leicht bewölkt;17;17;0
23.06.2020 23:00;187;73;114;Sonnig;16;16;0
24.06.2020 00:00;98;35;63;Sonnig;15;15;0
24.06.2020 01:00;39;17;22;Sonnig;14;14;0
24.06.2020 02:00;25;11;14;Sonnig;14;13;0
24.06.2020 03:00;12;6;6;Sonnig;13;13;0
24.06.2020 04:00;13;7;6;Sonnig;14;14;0
24.06.2020 05:00;78;49;29;Leicht bewölkt;15;15;0
24.06.2020 06:00;204;118;86;Leicht bewölkt;16;16;0
24.06.2020 07:00;835;515;320;Leicht bewölkt;18;18;0
24.06.2020 08:00;765;450;315;Sonnig;19;19;0
24.06.2020 09:00;698;424;274;Sonnig;21;21;0
24.06.2020 10:00;745;406;339;Sonnig;22;22;0
24.06.2020 11:00;846;438;408;Sonnig;23;24;0
24.06.2020 12:00;860;415;445;Sonnig;24;25;0
24.06.2020 13:00;1044;477;567;Sonnig;24;25;0
24.06.2020 14:00;962;446;516;Sonnig;24;25;0
24.06.2020 15:00;1088;516;572;Sonnig;24;25;0
24.06.2020 16:00;1053;513;540;Sonnig;23;24;0
24.06.2020 17:00;1271;600;671;Sonnig;22;23;0
24.06.2020 18:00;1087;471;616;Sonnig;21;21;0
24.06.2020 19:00;857;390;467;Sonnig;20;19;0
24.06.2020 20:00;693;321;372;Sonnig;18;18;0
24.06.2020 21:00;549;208;341;Sonnig;17;16;0
24.06.2020 22:00;416;157;259;Sonnig;16;16;0
24.06.2020 23:00;197;62;135;Sonnig;15;15;0
25.06.2020 00:00;108;44;64;Sonnig;15;15;0
25.06.2020 01:00;50;26;24;Sonnig;14;14;0
25.06.2020 02:00;18;7;11;Sonnig;14;14;0
25.06.2020 03:00;11;4;7;Sonnig;13;13;0
25.06.2020 04:00;21;9;12;Sonnig;14;14;0
25.06.2020 05:00;62;37;25;Sonnig;15;15;0
25.06.2020 06:00;198;116;82;Sonnig;16;16;0
25.06.2020 07:00;776;477;299;Sonnig;17;17;0
25.06.2020 08:00;738;431;307;Leicht bewölkt;19;19;0
25.06.2020 09:00;798;476;322;Leicht bewölkt;21;21;0
25.06.2020 10:00;730;393;337;Leicht bewölkt;21;21;0
25.06.2020 11:00;847;421;426;Leicht bewölkt;22;24;0
25.06.2020 12:00;806;386;420;Leicht bewölkt;23;25;0
25.06.2020 13:00;1138;495;643;Leicht bewölkt;23;25;0
25.06.2020 14:00;894;453;441;Leicht bewölkt;24;25;0
25.06.2020 15:00;1034;500;534;Leicht bewölkt;24;25;0
25.06.2020 16:00;1136;559;577;Leicht bewölkt;24;25;0
25.06.2020 17:00;1195;534;661;Leicht bewölkt;23;25;0
25.06.2020 18:00;1166;528;638;Leicht bewölkt;22;25;0
25.06.2020 19:00;925;403;522;Leicht bewölkt;22;22;0
25.06.2020 20:00;723;351;372;Leicht bewölkt;21;21;0
25.06.2020 21:00;597;261;336;Leicht bewölkt;20;20;0
25.06.2020 22:00;395;168;227;Leicht bewölkt;19;19;0
25.06.2020 23:00;222;94;128;Leicht bewölkt;17;17;0
26.06.2020 00:00;137;44;93;Leicht bewölkt;16;16;0
26.06.2020 01:00;72;28;44;Leicht bewölkt;15;15;0
26.06.2020 02:00;19;9;10;Leicht bewölkt;14;14;0
26.06.2020 03:00;12;5;7;Leicht bewölkt;13;13;0
26.06.2020 04:00;9;4;5;Leicht bewölkt;14;14;0
26.06.2020 05:00;68;46;22;Stellenweiser Regenfall;15;15;2
26.06.2020 06:00;148;84;64;Stellenweiser Regenfall;16;16;3
26.06.2020 07:00;586;369;217;Stellenweiser Regenfall;18;18;1
26.06.2020 08:00;578;346;232;Stellenweiser Regenfall;19;19;2
26.06.2020 09:00;627;383;244;Stellenweiser Regenfall;21;21;2
26.06.2020 10:00;609;349;260;Stellenweiser Regenfall;22;24;1
26.06.2020 11:00;661;356;305;Stellenweiser Regenfall;24;25;5
26.06.2020 12:00;733;367;366;Stellenweiser Regenfall;25;26;7
26.06.2020 13:00;843;366;477;Stellenweiser Regenfall;26;27;3
26.06.2020 14:00;802;364;438;Nieselregen mit Gewitter;26;28;2
26.06.2020 15:00;921;444;477;Nieselregen mit Gewitter;27;28;3
26.06.2020 16:00;823;406;417;Nieselregen mit Gewitter;27;28;2
26.06.2020 17:00;876;382;494;Stellenweiser Regenfall;26;28;4
26.06.2020 18:00;657;269;388;Stellenweiser Regenfall;26;28;5
26.06.2020 19:00;596;275;321;Stellenweiser Regenfall;25;27;3
26.06.2020 20:00;464;222;242;Leichter Regenschauer;24;26;2
26.06.2020 21:00;362;181;181;Leichter Regenschauer;23;25;3
26.06.2020 22:00;321;123;198;Leichter Regenschauer;21;21;1
26.06.2020 23:00;236;96;140;Stellenweiser Regenfall;19;19;0
27.06.2020 00:00;197;73;124;Stellenweiser Regenfall;17;17;0
27.06.2020 01:00;133;50;83;Stellenweiser Regenfall;16;16;0
27.06.2020 02:00;88;33;55;Leicht bewölkt;15;16;2
27.06.2020 03:00;71;21;50;Leicht bewölkt;14;15;3
27.06.2020 04:00;35;9;26;Leicht bewölkt;15;15;1
27.06.2020 05:00;26;12;14;Stellenweiser Regenfall;16;16;4
27.06.2020 06:00;71;39;32;Stellenweiser Regenfall;17;17;5
27.06.2020 07:00;107;51;56;Stellenweiser Regenfall;18;18;3
27.06.2020 08:00;243;150;93;Leichter Regenschauer;20;20;1
27.06.2020 09:00;494;318;176;Leichter Regenschauer;22;22;2
27.06.2020 10:00;601;344;257;Leichter Regenschauer;23;24;1
27.06.2020 11:00;606;307;299;Leicht bewölkt;24;25;0
27.06.2020 12:00;700;382;318;Leicht bewölkt;26;27;0
27.06.2020 13:00;715;365;350;Leicht bewölkt;26;27;0
27.06.2020 14:00;862;436;426;Leicht bewölkt;27;28;0
27.06.2020 15:00;804;370;434;Leicht bewölkt;28;28;0
27.06.2020 16:00;743;370;373;Leicht bewölkt;27;28;0
27.06.2020 17:00;803;418;385;Leicht bewölkt;27;27;0
27.06.2020 18:00;682;279;403;Leicht bewölkt;26;27;0
27.06.2020 19:00;626;322;304;Leicht bewölkt;25;26;0
27.06.2020 20:00;484;248;236;Leicht bewölkt;24;26;4
27.06.2020 21:00;420;175;245;Leicht bewölkt;23;25;5
27.06.2020 22:00;301;145;156;Leicht bewölkt;21;21;2
27.06.2020 23:00;240;102;138;Stellenweiser Regenfall;20;20;6
28.06.2020 00:00;216;77;139;Stellenweiser Regenfall;18;18;11
28.06.2020 01:00;144;57;87;Stellenweiser Regenfall;17;17;6
28.06.2020 02:00;85;26;59;Stellenweiser Regenfall;16;16;2
28.06.2020 03:00;75;26;49;Stellenweiser Regenfall;15;15;3
28.06.2020 04:00;50;19;31;Stellenweiser Regenfall;16;16;1
28.06.2020 05:00;22;8;14;Leicht bewölkt;17;17;0
28.06.2020 06:00;28;20;8;Leicht bewölkt;18;18;0
28.06.2020 07:00;46;23;23;Leicht bewölkt;19;19;0
28.06.2020 08:00;107;47;60;Leicht bewölkt;21;21;0
28.06.2020 09:00;256;152;104;Leicht bewölkt;22;23;0
28.06.2020 10:00;351;205;146;Leicht bewölkt;23;24;0
28.06.2020 11:00;388;178;210;Leicht bewölkt;23;25;0
28.06.2020 12:00;425;200;225;Leicht bewölkt;24;26;0
28.06.2020 13:00;480;220;260;Leicht bewölkt;24;26;0
28.06.2020 14:00;511;241;270;Stellenweiser Regenfall;24;26;5
28.06.2020 15:00;552;293;259;Stellenweiser Regenfall;24;26;6
28.06.2020 16:00;475;242;233;Stellenweiser Regenfall;23;24;3
28.06.2020 17:00;587;292;295;Leichter Regenschauer;22;23;11
28.06.2020 18:00;564;270;294;Leichter Regenschauer;21;21;15
28.06.2020 19:00;482;193;289;Leichter Regenschauer;20;20;7
28.06.2020 20:00;313;126;187;Mäßiger bis starker Regenschauer;19;19;8
28.06.2020 21:00;208;100;108;Mäßiger bis starker Regenschauer;18;18;11
28.06.2020 22:00;126;64;62;Mäßiger bis starker Regenschauer;17;17;6
28.06.2020 23:00;67;25;42;Leichter Regenschauer;16;16;1
29.06.2020 00:00;28;13;15;Leichter Regenschauer;16;16;19
29.06.2020 01:00;22;13;9;Leichter Regenschauer;16;16;1
29.06.2020 02:00;10;7;3;Mäßiger Regenfall;16;16;7
29.06.2020 03:00;5;1;4;Mäßiger Regenfall;15;15;9
29.06.2020 04:00;10;9;1;Mäßiger Regenfall;15;15;4
29.06.2020 05:00;26;15;11;Leichter Regenfall;15;15;14
29.06.2020 06:00;112;62;50;Leichter Regenfall;15;14;18
29.06.2020 07:00;351;226;125;Leichter Regenfall;14;14;9
29.06.2020 08:00;444;255;189;Mäßiger Regenfall;14;14;19
29.06.2020 09:00;396;235;161;Mäßiger Regenfall;14;14;25
29.06.2020 10:00;341;197;144;Mäßiger Regenfall;15;15;13
29.06.2020 11:00;453;258;195;Mäßiger Regenfall;17;16;12
29.06.2020 12:00;535;294;241;Mäßiger Regenfall;18;18;16
29.06.2020 13:00;708;366;342;Mäßiger Regenfall;19;19;8
29.06.2020 14:00;617;307;310;Stellenweiser leichter Regenfall;20;20;4
29.06.2020 15:00;778;401;377;Stellenweiser leichter Regenfall;22;22;5
29.06.2020 16:00;908;434;474;Stellenweiser leichter Regenfall;21;21;2
29.06.2020 17:00;937;415;522;Stellenweiser Regenfall;21;21;0
29.06.2020 18:00;840;390;450;Stellenweiser Regenfall;20;20;0
29.06.2020 19:00;686;289;397;Stellenweiser Regenfall;19;19;0
29.06.2020 20:00;552;255;297;Leicht bewölkt;17;17;0
29.06.2020 21:00;401;168;233;Leicht bewölkt;16;16;0
29.06.2020 22:00;267;99;168;Leicht bewölkt;15;15;0
29.06.2020 23:00;128;57;71;Stellenweiser Regenfall;14;14;0
30.06.2020 00:00;96;44;52;Stellenweiser Regenfall;13;13;0
30.06.2020 01:00;38;8;30;Stellenweiser Regenfall;12;13;0
30.06.2020 02:00;13;5;8;Bedeckt;12;12;0
30.06.2020 03:00;8;3;5;Bedeckt;11;12;0
30.06.2020 04:00;17;13;4;Bedeckt;12;12;0
30.06.2020 05:00;54;35;19;Leicht bewölkt;13;13;0
30.06.2020 06:00;192;116;76;Leicht bewölkt;14;14;0
30.06.2020 07:00;766;507;259;Leicht bewölkt;16;16;0
30.06.2020 08:00;831;487;344;Leicht bewölkt;17;17;0
30.06.2020 09:00;732;436;296;Leicht bewölkt;19;19;0
30.06.2020 10:00;723;384;339;Leicht bewölkt;20;20;0
30.06.2020 11:00;818;414;404;Leicht bewölkt;21;21;0
30.06.2020 12:00;931;455;476;Leicht bewölkt;23;23;0
30.06.2020 13:00;1089;508;581;Leicht bewölkt;23;24;0
30.06.2020 14:00;907;425;482;Leicht bewölkt;24;25;0
30.06.2020 15:00;1092;495;597;Leicht bewölkt;24;25;0
30.06.2020 16:00;1124;526;598;Leicht bewölkt;24;25;0
30.06.2020 17:00;1251;600;651;Leicht bewölkt;23;25;0
30.06.2020 18:00;1072;438;634;Leicht bewölkt;23;25;0
30.06.2020 19:00;907;400;507;Leicht bewölkt;22;24;0
30.06.2020 20:00;690;333;357;Leicht bewölkt;21;21;0
30.06.2020 21:00;468;203;265;Leicht bewölkt;21;21;0
30.06.2020 22:00;366;136;230;Leicht bewölkt;19;19;0
30.06.2020 23:00;252;94;158;Leicht bewölkt;17;17;0
01.07.2020 00:00;104;41;63;Leicht bewölkt;15;15;0
01.07.2020 01:00;46;16;30;Leicht bewölkt;14;14;0
01.07.2020 02:00;15;5;10;Leicht bewölkt;14;14;0
01.07.2020 03:00;16;5;11;Leicht bewölkt;13;13;0
01.07.2020 04:00;8;6;2;Leicht bewölkt;14;14;0
01.07.2020 05:00;57;35;22;Leicht bewölkt;15;15;0
01.07.2020 06:00;228;138;90;Leicht bewölkt;17;17;0
01.07.2020 07:00;822;512;310;Leicht bewölkt;19;19;0
01.07.2020 08:00;880;509;371;Leicht bewölkt;21;21;0
01.07.2020 09:00;829;487;342;Leicht bewölkt;23;24;0
01.07.2020 10:00;753;435;318;Leicht bewölkt;24;25;0
01.07.2020 11:00;821;426;395;Leicht bewölkt;25;26;0
01.07.2020 12:00;979;442;537;Leicht bewölkt;26;27;0
01.07.2020 13:00;1046;476;570;Leicht bewölkt;27;28;0
01.07.2020 14:00;920;429;491;Leicht bewölkt;28;28;0
01.07.2020 15:00;1065;485;580;Leicht bewölkt;28;29;0
01.07.2020 16:00;1101;483;618;Leicht bewölkt;28;29;0
01.07.2020 17:00;1194;569;625;Stellenweiser Regenfall;27;29;0
01.07.2020 18:00;1067;477;590;Stellenweiser Regenfall;27;29;0
01.07.2020 19:00;878;393;485;Stellenweiser Regenfall;26;28;0
01.07.2020 20:00;677;303;374;Leicht bewölkt;25;28;14
01.07.2020 21:00;482;190;292;Leicht bewölkt;25;27;18
01.07.2020 22:00;396;144;252;Leicht bewölkt;22;24;9
01.07.2020 23:00;210;69;141;Mäßiger bis starker Regenschauer;20;20;8
02.07.2020 00:00;96;34;62;Mäßiger bis starker Regenschauer;18;18;11
02.07.2020 01:00;48;21;27;Mäßiger bis starker Regenschauer;18;18;5
02.07.2020 02:00;28;15;13;Leichter Regenschauer;17;17;8
02.07.2020 03:00;15;6;9;Leichter Regenschauer;16;16;11
02.07.2020 04:00;9;5;4;Leichter Regenschauer;17;17;5
02.07.2020 05:00;50;35;15;Mäßiger Regenfall;18;18;8
02.07.2020 06:00;153;93;60;Mäßiger Regenfall;18;18;1
02.07.2020 07:00;776;493;283;Mäßiger Regenfall;19;19;5
02.07.2020 08:00;780;461;319;Stellenweiser leichter Regenfall;20;20;6
02.07.2020 09:00;653;416;237;Stellenweiser leichter Regenfall;21;21;8
02.07.2020 10:00;567;313;254;Stellenweiser leichter Regenfall;21;21;4
02.07.2020 11:00;695;354;341;Leichter Regenschauer;22;24;2
02.07.2020 12:00;815;387;428;Leichter Regenschauer;23;25;2
02.07.2020 13:00;914;424;490;Leichter Regenschauer;23;25;1
02.07.2020 14:00;781;345;436;Bewölkt;23;25;6
02.07.2020 15:00;798;377;421;Bewölkt;23;25;8
02.07.2020 16:00;1015;522;493;Bewölkt;22;22;4
02.07.2020 17:00;1024;462;562;Mäßiger bis starker Regenschauer;21;21;4
02.07.2020 18:00;979;428;551;Mäßiger bis starker Regenschauer;20;20;6
02.07.2020 19:00;748;326;422;Mäßiger bis starker Regenschauer;19;19;3
02.07.2020 20:00;557;224;333;Leichter Regenschauer;17;17;1
02.07.2020 21:00;361;144;217;Leichter Regenschauer;16;16;2
02.07.2020 22:00;310;108;202;Leichter Regenschauer;16;16;1
02.07.2020 23:00;200;66;134;Leichter Regenschauer;15;15;1
03.07.2020 00:00;119;50;69;Leichter Regenschauer;14;15;1
03.07.2020 01:00;70;26;44;Leichter Regenschauer;14;14;1
03.07.2020 02:00;10;2;8;Leichter Regenschauer;14;14;1
03.07.2020 03:00;48;19;29;Leichter Regenschauer;13;14;1
03.07.2020 04:00;7;5;2;Leichter Regenschauer;13;14;1
03.07.2020 05:00;56;40;16;Nieselregen;14;14;1
03.07.2020 06:00;163;93;70;Nieselregen;14;15;2
03.07.2020 07:00;724;473;251;Nieselregen;15;16;1
03.07.2020 08:00;717;432;285;Stellenweiser Nieselregen;16;17;1
03.07.2020 09:00;735;463;272;Stellenweiser Nieselregen;18;18;1
03.07.2020 10:00;736;427;309;Stellenweiser Nieselregen;19;19;0
03.07.2020 11:00;903;466;437;Stellenweiser Regenfall;20;20;0
03.07.2020 12:00;805;368;437;Stellenweiser Regenfall;21;21;0
03.07.2020 13:00;1002;442;560;Stellenweiser Regenfall;21;21;0
03.07.2020 14:00;824;388;436;Stellenweiser Regenfall;21;21;0
03.07.2020 15:00;890;482;408;Stellenweiser Regenfall;21;21;0
03.07.2020 16:00;861;426;435;Stellenweiser Regenfall;21;21;0
03.07.2020 17:00;994;487;507;Stellenweiser Regenfall;20;20;1
03.07.2020 18:00;870;353;517;Stellenweiser Regenfall;20;20;1
03.07.2020 19:00;717;333;384;Stellenweiser Regenfall;20;20;0
03.07.2020 20:00;508;261;247;Stellenweiser Regenfall;19;19;0
03.07.2020 21:00;357;157;200;Stellenweiser Regenfall;18;18;0
03.07.2020 22:00;356;138;218;Stellenweiser Regenfall;17;17;0
03.07.2020 23:00;229;84;145;Stellenweiser Regenfall;15;15;0
04.07.2020 00:00;195;86;109;Stellenweiser Regenfall;14;14;0
04.07.2020 01:00;126;43;83;Stellenweiser Regenfall;13;13;0
04.07.2020 02:00;88;34;54;Stellenweiser Regenfall;12;12;0
04.07.2020 03:00;46;10;36;Stellenweiser Regenfall;11;11;0
04.07.2020 04:00;46;22;24;Stellenweiser Regenfall;12;12;0
04.07.2020 05:00;38;20;18;Leicht bewölkt;13;13;0
04.07.2020 06:00;60;28;32;Leicht bewölkt;14;14;0
04.07.2020 07:00;111;64;47;Leicht bewölkt;16;16;0
04.07.2020 08:00;249;148;101;Leicht bewölkt;18;18;0
04.07.2020 09:00;513;326;187;Leicht bewölkt;20;20;0
04.07.2020 10:00;720;390;330;Leicht bewölkt;21;21;0
04.07.2020 11:00;791;388;403;Leicht bewölkt;22;22;0
04.07.2020 12:00;785;400;385;Leicht bewölkt;23;25;0
04.07.2020 13:00;774;392;382;Leicht bewölkt;23;25;0
04.07.2020 14:00;816;418;398;Leicht bewölkt;24;25;0
04.07.2020 15:00;795;389;406;Leicht bewölkt;24;25;0
04.07.2020 16:00;822;361;461;Leicht bewölkt;23;25;0
04.07.2020 17:00;842;393;449;Leicht bewölkt;23;25;0
04.07.2020 18:00;875;395;480;Leicht bewölkt;22;25;0
04.07.2020 19:00;746;345;401;Leicht bewölkt;21;21;0
04.07.2020 20:00;602;289;313;Leicht bewölkt;20;20;0
04.07.2020 21:00;420;169;251;Leicht bewölkt;19;19;0
04.07.2020 22:00;389;175;214;Leicht bewölkt;18;18;0
04.07.2020 23:00;288;104;184;Leicht bewölkt;16;16;0
05.07.2020 00:00;218;93;125;Leicht bewölkt;14;15;0
05.07.2020 01:00;157;62;95;Leicht bewölkt;14;14;0
05.07.2020 02:00;84;25;59;Leicht bewölkt;13;13;0
05.07.2020 03:00;71;27;44;Leicht bewölkt;13;13;0
05.07.2020 04:00;35;11;24;Leicht bewölkt;14;14;0
05.07.2020 05:00;35;15;20;Leicht bewölkt;15;15;0
05.07.2020 06:00;37;23;14;Leicht bewölkt;16;16;0
05.07.2020 07:00;62;40;22;Leicht bewölkt;17;17;0
05.07.2020 08:00;157;84;73;Leicht bewölkt;19;19;0
05.07.2020 09:00;319;166;153;Leicht bewölkt;20;20;0
05.07.2020 10:00;438;204;234;Leicht bewölkt;22;22;0
05.07.2020 11:00;496;256;240;Leicht bewölkt;23;24;0
05.07.2020 12:00;558;205;353;Leicht bewölkt;24;26;0
05.07.2020 13:00;586;343;243;Leicht bewölkt;25;26;0
05.07.2020 14:00;628;300;328;Leicht bewölkt;25;26;0
05.07.2020 15:00;644;317;327;Leicht bewölkt;26;27;0
05.07.2020 16:00;622;322;300;Leicht bewölkt;25;26;0
05.07.2020 17:00;586;286;300;Leicht bewölkt;24;26;0
05.07.2020 18:00;738;392;346;Leicht bewölkt;24;25;0
05.07.2020 19:00;599;286;313;Leicht bewölkt;23;25;0
05.07.2020 20:00;440;194;246;Leicht bewölkt;22;22;0
05.07.2020 21:00;403;152;251;Leicht bewölkt;21;21;0
05.07.2020 22:00;236;98;138;Leicht bewölkt;19;19;0
05.07.2020 23:00;145;59;86;Leicht bewölkt;18;18;0
06.07.2020 00:00;68;36;32;Leicht bewölkt;16;16;0
06.07.2020 01:00;22;8;14;Leicht bewölkt;16;16;0
06.07.2020 02:00;6;2;4;Leicht bewölkt;15;15;0
06.07.2020 03:00;7;5;2;Leicht bewölkt;14;14;0
06.07.2020 04:00;17;10;7;Leicht bewölkt;15;15;0
06.07.2020 05:00;53;32;21;Leicht bewölkt;16;16;0
06.07.2020 06:00;191;117;74;Leicht bewölkt;17;17;0
06.07.2020 07:00;763;477;286;Leicht bewölkt;18;18;0
06.07.2020 08:00;785;460;325;Bewölkt;19;19;0
06.07.2020 09:00;667;399;268;Bewölkt;21;21;0
06.07.2020 10:00;567;278;289;Bewölkt;20;20;0
06.07.2020 11:00;595;293;302;Stellenweiser Regenfall;19;19;0
06.07.2020 12:00;685;345;340;Stellenweiser Regenfall;18;18;0
06.07.2020 13:00;834;398;436;Stellenweiser Regenfall;18;18;0
06.07.2020 14:00;788;404;384;Stellenweiser Regenfall;17;17;1
06.07.2020 15:00;879;460;419;Stellenweiser Regenfall;17;17;1
06.07.2020 16:00;1024;492;532;Stellenweiser Regenfall;16;16;0
06.07.2020 17:00;1081;491;590;Nieselregen;16;16;2
06.07.2020 18:00;992;441;551;Nieselregen;16;16;2
06.07.2020 19:00;708;341;367;Nieselregen;15;15;1
06.07.2020 20:00;561;242;319;Stellenweiser Regenfall;14;14;1
06.07.2020 21:00;352;142;210;Stellenweiser Regenfall;13;14;1
06.07.2020 22:00;280;106;174;Stellenweiser Regenfall;12;12;0
06.07.2020 23:00;156;60;96;Leicht bewölkt;11;11;0
07.07.2020 00:00;74;31;43;Leicht bewölkt;10;10;0
07.07.2020 01:00;54;21;33;Leicht bewölkt;9;9;0
07.07.2020 02:00;10;4;6;Leicht bewölkt;9;9;0
07.07.2020 03:00;13;6;7;Leicht bewölkt;8;8;0
07.07.2020 04:00;7;6;1;Leicht bewölkt;9;9;0
07.07.2020 05:00;76;52;24;Leicht bewölkt;10;10;0
07.07.2020 06:00;204;122;82;Leicht bewölkt;11;11;0
07.07.2020 07:00;825;521;304;Leicht bewölkt;13;13;0
07.07.2020 08:00;892;488;404;Leicht bewölkt;15;15;0
07.07.2020 09:00;698;418;280;Leicht bewölkt;17;17;0
07.07.2020 10:00;745;361;384;Leicht bewölkt;18;18;0
07.07.2020 11:00;890;448;442;Sonnig;19;19;0
07.07.2020 12:00;905;420;485;Sonnig;20;20;0
07.07.2020 13:00;1011;466;545;Sonnig;20;20;0
07.07.2020 14:00;936;467;469;Leicht bewölkt;20;20;0
07.07.2020 15:00;1115;518;597;Leicht bewölkt;20;20;0
07.07.2020 16:00;1112;531;581;Leicht bewölkt;20;20;0
07.07.2020 17:00;1319;617;702;Sonnig;19;19;0
07.07.2020 18:00;1203;526;677;Sonnig;19;19;0
07.07.2020 19:00;960;467;493;Sonnig;18;18;0
07.07.2020 20:00;695;338;357;Leicht bewölkt;17;17;0
07.07.2020 21:00;472;194;278;Leicht bewölkt;16;16;0
07.07.2020 22:00;389;135;254;Leicht bewölkt;15;15;0
07.07.2020 23:00;186;60;126;Leicht bewölkt;14;14;0
08.07.2020 00:00;90;30;60;Leicht bewölkt;12;12;0
08.07.2020 01:00;38;10;28;Leicht bewölkt;12;12;0
08.07.2020 02:00;15;5;10;Leicht bewölkt;11;11;0
08.07.2020 03:00;13;6;7;Leicht bewölkt;10;10;0
08.07.2020 04:00;17;10;7;Leicht bewölkt;11;11;0
08.07.2020 05:00;66;45;21;Leicht bewölkt;12;12;0
08.07.2020 06:00;198;120;78;Leicht bewölkt;14;14;0
08.07.2020 07:00;855;555;300;Leicht bewölkt;15;15;0
08.07.2020 08:00;862;498;364;Leicht bewölkt;17;17;0
08.07.2020 09:00;843;485;358;Leicht bewölkt;19;19;0
08.07.2020 10:00;717;377;340;Leicht bewölkt;20;20;0
08.07.2020 11:00;848;437;411;Leicht bewölkt;22;22;0
08.07.2020 12:00;944;442;502;Leicht bewölkt;23;24;0
08.07.2020 13:00;1010;442;568;Leicht bewölkt;24;24;0
08.07.2020 14:00;934;489;445;Leicht bewölkt;24;25;0
08.07.2020 15:00;1038;477;561;Leicht bewölkt;25;26;0
08.07.2020 16:00;1136;537;599;Leicht bewölkt;24;25;0
08.07.2020 17:00;1271;560;711;Leicht bewölkt;24;25;0
08.07.2020 18:00;1153;547;606;Leicht bewölkt;23;25;0
08.07.2020 19:00;822;389;433;Leicht bewölkt;22;22;0
08.07.2020 20:00;640;262;378;Leicht bewölkt;20;20;0
08.07.2020 21:00;554;221;333;Leicht bewölkt;19;19;0
08.07.2020 22:00;407;159;248;Leicht bewölkt;18;18;0
08.07.2020 23:00;228;92;136;Leicht bewölkt;17;17;0
09.07.2020 00:00;129;42;87;Leicht bewölkt;16;16;0
09.07.2020 01:00;63;26;37;Leicht bewölkt;15;15;0
09.07.2020 02:00;23;7;16;Leicht bewölkt;14;14;0
09.07.2020 03:00;9;2;7;Leicht bewölkt;13;13;0
09.07.2020 04:00;11;9;2;Leicht bewölkt;14;14;0
09.07.2020 05:00;63;45;18;Leicht bewölkt;15;15;0
09.07.2020 06:00;207;120;87;Leicht bewölkt;16;16;0
09.07.2020 07:00;863;547;316;Leicht bewölkt;17;17;0
09.07.2020 08:00;827;471;356;Leicht bewölkt;19;19;0
09.07.2020 09:00;824;480;344;Leicht bewölkt;21;21;0
09.07.2020 10:00;719;349;370;Leicht bewölkt;22;23;0
09.07.2020 11:00;786;434;352;Leicht bewölkt;23;24;0
09.07.2020 12:00;911;428;483;Leicht bewölkt;24;26;0
09.07.2020 13:00;1101;481;620;Leicht bewölkt;25;26;0
09.07.2020 14:00;988;480;508;Leicht bewölkt;25;26;0
09.07.2020 15:00;1021;470;551;Leicht bewölkt;26;27;0
09.07.2020 16:00;1074;485;589;Leicht bewölkt;25;26;0
09.07.2020 17:00;1208;585;623;Leicht bewölkt;25;26;0
09.07.2020 18:00;1183;589;594;Leicht bewölkt;24;26;0
09.07.2020 19:00;965;468;497;Leicht bewölkt;23;25;0
09.07.2020 20:00;686;285;401;Leicht bewölkt;22;22;0
09.07.2020 21:00;541;213;328;Leicht bewölkt;21;21;0
09.07.2020 22:00;485;170;315;Leicht bewölkt;19;19;0
09.07.2020 23:00;270;91;179;Leicht bewölkt;18;18;0
10.07.2020 00:00;149;39;110;Leicht bewölkt;17;17;0
10.07.2020 01:00;58;16;42;Leicht bewölkt;16;16;0
10.07.2020 02:00;27;9;18;Leicht bewölkt;15;16;0
10.07.2020 03:00;10;1;9;Leicht bewölkt;15;15;0
10.07.2020 04:00;15;9;6;Leicht bewölkt;15;16;0
10.07.2020 05:00;55;35;20;Leicht bewölkt;16;17;0
10.07.2020 06:00;199;105;94;Leicht bewölkt;17;18;0
10.07.2020 07:00;725;468;257;Leicht bewölkt;19;19;0
10.07.2020 08:00;801;480;321;Leicht bewölkt;21;21;0
10.07.2020 09:00;780;472;308;Leicht bewölkt;23;24;0
10.07.2020 10:00;809;436;373;Leicht bewölkt;24;25;0
10.07.2020 11:00;942;493;449;Leicht bewölkt;25;26;0
10.07.2020 12:00;969;415;554;Leicht bewölkt;27;27;0
10.07.2020 13:00;966;388;578;Leicht bewölkt;26;27;0
10.07.2020 14:00;958;461;497;Leicht bewölkt;26;27;2
10.07.2020 15:00;910;445;465;Leicht bewölkt;25;26;3
10.07.2020 16:00;901;440;461;Leicht bewölkt;24;26;2
10.07.2020 17:00;959;434;525;Stellenweiser Regenfall;23;25;3
10.07.2020 18:00;846;386;460;Stellenweiser Regenfall;22;25;4
10.07.2020 19:00;727;325;402;Stellenweiser Regenfall;21;21;2
10.07.2020 20:00;527;207;320;Leichter Regenschauer;19;19;2
10.07.2020 21:00;391;164;227;Leichter Regenschauer;18;18;2
10.07.2020 22:00;303;99;204;Leichter Regenschauer;17;17;1
10.07.2020 23:00;244;96;148;Starker Regenfall;16;16;53
11.07.2020 00:00;136;70;66;Starker Regenfall;16;16;71
11.07.2020 01:00;98;39;59;Starker Regenfall;15;15;36
11.07.2020 02:00;76;24;52;Starker Regenfall;15;15;33
11.07.2020 03:00;36;15;21;Starker Regenfall;15;15;44
11.07.2020 04:00;20;10;10;Starker Regenfall;15;16;22
11.07.2020 05:00;28;14;14;Mäßiger Regenfall;15;16;21
11.07.2020 06:00;27;16;11;Mäßiger Regenfall;16;16;28
11.07.2020 07:00;44;23;21;Mäßiger Regenfall;16;16;14
11.07.2020 08:00;88;60;28;Teilweise mäßiger Regenfall;16;16;11
11.07.2020 09:00;191;114;77;Teilweise mäßiger Regenfall;17;17;15
11.07.2020 10:00;385;229;156;Teilweise mäßiger Regenfall;17;17;7
11.07.2020 11:00;515;284;231;Stellenweiser Regenfall;17;17;6
11.07.2020 12:00;680;388;292;Stellenweiser Regenfall;17;17;8
11.07.2020 13:00;712;371;341;Stellenweiser Regenfall;18;18;4
11.07.2020 14:00;656;376;280;Leichter Regenschauer;18;18;6
11.07.2020 15:00;767;433;334;Leichter Regenschauer;18;18;8
11.07.2020 16:00;666;318;348;Leichter Regenschauer;18;18;4
11.07.2020 17:00;284;126;158;Stellenweiser Regenfall;18;18;8
11.07.2020 18:00;627;248;379;Stellenweiser Regenfall;17;17;11
11.07.2020 19:00;475;232;243;Stellenweiser Regenfall;16;16;5
11.07.2020 20:00;420;203;217;Mäßiger bis starker Regenschauer;14;14;4
11.07.2020 21:00;297;159;138;Mäßiger bis starker Regenschauer;13;13;5
11.07.2020 22:00;239;122;117;Mäßiger bis starker Regenschauer;12;12;2
11.07.2020 23:00;235;113;122;Stellenweiser Regenfall;12;11;0
12.07.2020 00:00;169;71;98;Stellenweiser Regenfall;11;11;0
12.07.2020 01:00;122;37;85;Stellenweiser Regenfall;11;10;0
12.07.2020 02:00;77;28;49;Stellenweiser Regenfall;10;10;0
12.07.2020 03:00;46;21;25;Stellenweiser Regenfall;9;9;0
12.07.2020 04:00;19;11;8;Stellenweiser Regenfall;10;10;0
12.07.2020 05:00;37;18;19;Leicht bewölkt;11;11;0
12.07.2020 06:00;36;23;13;Leicht bewölkt;12;12;0
12.07.2020 07:00;59;32;27;Leicht bewölkt;14;13;0
12.07.2020 08:00;157;75;82;Leicht bewölkt;15;15;0
12.07.2020 09:00;308;170;138;Leicht bewölkt;17;17;0
12.07.2020 10:00;412;200;212;Leicht bewölkt;18;18;0
12.07.2020 11:00;524;227;297;Leicht bewölkt;19;19;0
12.07.2020 12:00;616;284;332;Leicht bewölkt;20;20;0
12.07.2020 13:00;613;278;335;Leicht bewölkt;21;21;0
12.07.2020 14:00;678;341;337;Leicht bewölkt;21;21;0
12.07.2020 15:00;739;398;341;Leicht bewölkt;21;21;0
12.07.2020 16:00;713;350;363;Leicht bewölkt;20;20;0
12.07.2020 17:00;669;287;382;Leicht bewölkt;20;20;0
12.07.2020 18:00;768;373;395;Leicht bewölkt;19;19;0
12.07.2020 19:00;587;272;315;Leicht bewölkt;18;17;0
12.07.2020 20:00;507;255;252;Leicht bewölkt;16;16;0
12.07.2020 21:00;380;153;227;Leicht bewölkt;15;14;0
12.07.2020 22:00;218;96;122;Leicht bewölkt;14;13;0
12.07.2020 23:00;125;54;71;Sonnig;13;13;0
13.07.2020 00:00;78;38;40;Sonnig;13;12;0
13.07.2020 01:00;31;12;19;Sonnig;12;11;0
13.07.2020 02:00;18;10;8;Leicht bewölkt;11;11;0
13.07.2020 03:00;11;0;11;Leicht bewölkt;10;10;0
13.07.2020 04:00;16;13;3;Leicht bewölkt;11;11;0
13.07.2020 05:00;49;30;19;Leicht bewölkt;12;12;0
13.07.2020 06:00;192;120;72;Leicht bewölkt;12;12;0
13.07.2020 07:00;774;483;291;Leicht bewölkt;14;14;0
13.07.2020 08:00;838;481;357;Leicht bewölkt;16;16;0
13.07.2020 09:00;700;392;308;Leicht bewölkt;17;18;0
13.07.2020 10:00;745;389;356;Leicht bewölkt;19;19;0
13.07.2020 11:00;825;447;378;Leicht bewölkt;20;20;0
13.07.2020 12:00;853;392;461;Leicht bewölkt;21;21;0
13.07.2020 13:00;1050;526;524;Leicht bewölkt;21;21;0
13.07.2020 14:00;934;460;474;Leicht bewölkt;22;22;0
13.07.2020 15:00;1157;588;569;Leicht bewölkt;22;25;0
13.07.2020 16:00;1118;506;612;Leicht bewölkt;21;21;0
13.07.2020 17:00;1168;502;666;Leicht bewölkt;20;20;0
13.07.2020 18:00;1120;530;590;Leicht bewölkt;20;20;0
13.07.2020 19:00;820;356;464;Leicht bewölkt;18;18;0
13.07.2020 20:00;676;320;356;Leicht bewölkt;17;17;0
13.07.2020 21:00;495;174;321;Leicht bewölkt;15;15;0
13.07.2020 22:00;329;129;200;Leicht bewölkt;14;14;0
13.07.2020 23:00;134;55;79;Leicht bewölkt;13;13;0
14.07.2020 00:00;87;32;55;Leicht bewölkt;12;12;0
14.07.2020 01:00;36;19;17;Leicht bewölkt;12;12;0
14.07.2020 02:00;16;6;10;Leicht bewölkt;11;11;0
14.07.2020 03:00;10;5;5;Leicht bewölkt;10;10;0
14.07.2020 04:00;7;4;3;Leicht bewölkt;11;11;0
14.07.2020 05:00;56;38;18;Leichter Nebel;12;12;0
14.07.2020 06:00;183;109;74;Leichter Nebel;13;13;0
14.07.2020 07:00;826;500;326;Leichter Nebel;15;15;0
14.07.2020 08:00;883;546;337;Leicht bewölkt;17;17;0
14.07.2020 09:00;770;455;315;Leicht bewölkt;19;19;0
14.07.2020 10:00;750;407;343;Leicht bewölkt;20;20;0
14.07.2020 11:00;910;477;433;Leicht bewölkt;22;22;0
14.07.2020 12:00;905;379;526;Leicht bewölkt;23;25;0
14.07.2020 13:00;1149;513;636;Leicht bewölkt;23;25;0
14.07.2020 14:00;968;444;524;Leicht bewölkt;23;25;0
14.07.2020 15:00;1102;498;604;Leicht bewölkt;23;25;0
14.07.2020 16:00;1207;595;612;Leicht bewölkt;23;24;0
14.07.2020 17:00;1284;576;708;Leicht bewölkt;22;22;0
14.07.2020 18:00;1058;451;607;Leicht bewölkt;21;21;0
14.07.2020 19:00;879;402;477;Leicht bewölkt;20;20;0
14.07.2020 20:00;602;271;331;Leicht bewölkt;19;19;1
14.07.2020 21:00;476;207;269;Leicht bewölkt;18;18;1
14.07.2020 22:00;399;157;242;Leicht bewölkt;16;16;0
14.07.2020 23:00;215;73;142;Stellenweiser Regenfall;15;15;1
15.07.2020 00:00;114;39;75;Stellenweiser Regenfall;14;14;1
15.07.2020 01:00;51;18;33;Stellenweiser Regenfall;13;13;1
15.07.2020 02:00;17;5;12;Stellenweiser Regenfall;12;13;0
15.07.2020 03:00;15;5;10;Stellenweiser Regenfall;12;12;0
15.07.2020 04:00;7;5;2;Stellenweiser Regenfall;12;13;0
15.07.2020 05:00;45;29;16;Leicht bewölkt;13;14;0
15.07.2020 06:00;184;96;88;Leicht bewölkt;14;14;0
15.07.2020 07:00;700;422;278;Leicht bewölkt;15;16;0
15.07.2020 08:00;783;460;323;Bedeckt;17;17;0
15.07.2020 09:00;622;361;261;Bedeckt;18;18;0
15.07.2020 10:00;543;308;235;Bedeckt;18;19;0
15.07.2020 11:00;653;366;287;Stellenweiser Regenfall;19;19;1
15.07.2020 12:00;765;352;413;Stellenweiser Regenfall;20;20;2
15.07.2020 13:00;859;410;449;Stellenweiser Regenfall;19;19;1
15.07.2020 14:00;727;370;357;Leichter Regenschauer;19;19;8
15.07.2020 15:00;934;440;494;Leichter Regenschauer;19;19;11
15.07.2020 16:00;901;469;432;Leichter Regenschauer;18;18;6
15.07.2020 17:00;963;468;495;Mäßiger bis starker Regenschauer;18;18;17
15.07.2020 18:00;907;424;483;Mäßiger bis starker Regenschauer;17;17;22
15.07.2020 19:00;630;280;350;Mäßiger bis starker Regenschauer;16;16;11
15.07.2020 20:00;448;190;258;Mäßiger bis starker Regenschauer;16;15;9
15.07.2020 21:00;297;114;183;Mäßiger bis starker Regenschauer;15;15;12
15.07.2020 22:00;220;98;122;Mäßiger bis starker Regenschauer;14;14;6
15.07.2020 23:00;147;50;97;Leichter Regenschauer;14;14;3
16.07.2020 00:00;62;20;42;Leichter Regenschauer;13;13;4
16.07.2020 01:00;36;18;18;Leichter Regenschauer;13;13;2
16.07.2020 02:00;14;6;8;Leichter Regenschauer;12;13;2
16.07.2020 03:00;10;2;8;Leichter Regenschauer;12;12;2
16.07.2020 04:00;8;5;3;Leichter Regenschauer;13;13;1
16.07.2020 05:00;33;22;11;Leichter Regenschauer;13;13;2
16.07.2020 06:00;137;73;64;Leichter Regenschauer;13;13;2
16.07.2020 07:00;682;441;241;Leichter Regenschauer;13;14;1
16.07.2020 08:00;697;431;266;Nieselregen;14;14;3
16.07.2020 09:00;583;358;225;Nieselregen;14;14;4
16.07.2020 10:00;482;268;214;Nieselregen;15;15;2
16.07.2020 11:00;559;313;246;Leichter Regenfall;16;16;4
16.07.2020 12:00;683;337;346;Leichter Regenfall;16;16;5
16.07.2020 13:00;844;400;444;Leichter Regenfall;17;17;3
16.07.2020 14:00;703;353;350;Stellenweiser leichter Regenfall;17;17;3
16.07.2020 15:00;722;330;392;Stellenweiser leichter Regenfall;18;18;4
16.07.2020 16:00;749;347;402;Stellenweiser leichter Regenfall;17;17;2
16.07.2020 17:00;759;340;419;Leichter Regenschauer;17;17;1
16.07.2020 18:00;705;290;415;Leichter Regenschauer;17;17;1
16.07.2020 19:00;399;184;215;Leichter Regenschauer;16;17;1
16.07.2020 20:00;310;143;167;Leicht bewölkt;16;16;1
16.07.2020 21:00;229;108;121;Leicht bewölkt;15;16;1
16.07.2020 22:00;191;85;106;Leicht bewölkt;15;15;1
16.07.2020 23:00;79;28;51;Leichter Regenfall;14;14;4
17.07.2020 00:00;66;28;38;Leichter Regenfall;14;14;6
17.07.2020 01:00;42;13;29;Leichter Regenfall;14;14;3
17.07.2020 02:00;24;6;18;Nieselregen;13;14;2
17.07.2020 03:00;11;2;9;Nieselregen;13;14;3
17.07.2020 04:00;1;1;0;Nieselregen;14;14;1
17.07.2020 05:00;34;21;13;Nieselregen;14;14;3
17.07.2020 06:00;147;73;74;Nieselregen;14;14;4
17.07.2020 07:00;606;390;216;Nieselregen;14;14;2
17.07.2020 08:00;662;415;247;Leichter Regenfall;15;15;4
17.07.2020 09:00;690;418;272;Leichter Regenfall;15;15;5
17.07.2020 10:00;692;383;309;Leichter Regenfall;16;16;2
17.07.2020 11:00;781;409;372;Leichter Regenschauer;18;18;5
17.07.2020 12:00;788;338;450;Leichter Regenschauer;19;19;7
17.07.2020 13:00;932;417;515;Leichter Regenschauer;20;20;3
17.07.2020 14:00;835;405;430;Leichter Regenschauer;20;20;2
17.07.2020 15:00;914;457;457;Leichter Regenschauer;21;21;3
17.07.2020 16:00;816;409;407;Leichter Regenschauer;20;20;2
17.07.2020 17:00;836;399;437;Stellenweiser Regenfall;19;19;2
17.07.2020 18:00;892;440;452;Stellenweiser Regenfall;19;19;2
17.07.2020 19:00;673;334;339;Stellenweiser Regenfall;17;18;1
17.07.2020 20:00;497;252;245;Stellenweiser Regenfall;16;17;1
17.07.2020 21:00;351;157;194;Stellenweiser Regenfall;15;16;1
17.07.2020 22:00;312;130;182;Stellenweiser Regenfall;14;15;1
17.07.2020 23:00;237;64;173;Leicht bewölkt;13;14;0
18.07.2020 00:00;177;51;126;Leicht bewölkt;13;13;0
18.07.2020 01:00;119;56;63;Leicht bewölkt;12;12;0
18.07.2020 02:00;61;15;46;Leicht bewölkt;11;11;0
18.07.2020 03:00;40;5;35;Leicht bewölkt;10;10;0
18.07.2020 04:00;27;19;8;Leicht bewölkt;11;11;0
18.07.2020 05:00;43;22;21;Leichter Nebel;12;12;0
18.07.2020 06:00;52;27;25;Leichter Nebel;13;13;0
18.07.2020 07:00;150;68;82;Leichter Nebel;15;15;0
18.07.2020 08:00;281;172;109;Leicht bewölkt;16;16;0
18.07.2020 09:00;504;313;191;Leicht bewölkt;18;18;0
18.07.2020 10:00;765;401;364;Leicht bewölkt;19;19;0
18.07.2020 11:00;867;440;427;Leicht bewölkt;20;20;0
18.07.2020 12:00;890;467;423;Leicht bewölkt;21;21;0
18.07.2020 13:00;857;440;417;Leicht bewölkt;21;21;0
18.07.2020 14:00;892;452;440;Leicht bewölkt;22;22;0
18.07.2020 15:00;879;439;440;Leicht bewölkt;22;25;0
18.07.2020 16:00;834;386;448;Leicht bewölkt;21;21;0
18.07.2020 17:00;839;379;460;Leicht bewölkt;20;20;0
18.07.2020 18:00;891;430;461;Leicht bewölkt;20;20;0
18.07.2020 19:00;721;328;393;Leicht bewölkt;18;18;0
18.07.2020 20:00;614;308;306;Leicht bewölkt;17;17;0
18.07.2020 21:00;500;267;233;Leicht bewölkt;16;16;0
18.07.2020 22:00;381;175;206;Leicht bewölkt;15;15;0
18.07.2020 23:00;279;103;176;Leicht bewölkt;14;14;0
19.07.2020 00:00;278;106;172;Leicht bewölkt;13;13;0
19.07.2020 01:00;173;66;107;Leicht bewölkt;12;12;0
19.07.2020 02:00;105;32;73;Leichter Nebel;12;12;0
19.07.2020 03:00;67;15;52;Leichter Nebel;11;11;0
19.07.2020 04:00;24;8;16;Leichter Nebel;12;12;0
19.07.2020 05:00;30;10;20;Leichter Nebel;13;13;0
19.07.2020 06:00;43;26;17;Leichter Nebel;14;14;0
19.07.2020 07:00;96;55;41;Leichter Nebel;15;15;0
19.07.2020 08:00;155;59;96;Leicht bewölkt;17;17;0
19.07.2020 09:00;346;193;153;Leicht bewölkt;19;19;0
19.07.2020 10:00;493;224;269;Leicht bewölkt;20;20;0
19.07.2020 11:00;565;238;327;Leicht bewölkt;22;22;0
19.07.2020 12:00;587;296;291;Leicht bewölkt;23;24;0
19.07.2020 13:00;686;363;323;Leicht bewölkt;23;24;0
19.07.2020 14:00;671;315;356;Leicht bewölkt;24;25;0
19.07.2020 15:00;646;317;329;Leicht bewölkt;24;25;0
19.07.2020 16:00;616;328;288;Leicht bewölkt;23;24;0
19.07.2020 17:00;707;324;383;Leicht bewölkt;23;23;0
19.07.2020 18:00;720;330;390;Leicht bewölkt;22;22;0
19.07.2020 19:00;589;298;291;Leicht bewölkt;20;20;0
19.07.2020 20:00;458;211;247;Leicht bewölkt;19;19;0
19.07.2020 21:00;364;148;216;Leicht bewölkt;17;17;0
19.07.2020 22:00;265;101;164;Leicht bewölkt;16;16;0
19.07.2020 23:00;130;46;84;Stellenweiser Regenfall;16;16;1
20.07.2020 00:00;62;24;38;Stellenweiser Regenfall;15;15;1
20.07.2020 01:00;48;16;32;Stellenweiser Regenfall;14;14;0
20.07.2020 02:00;14;6;8;Stellenweiser Regenfall;14;14;0
20.07.2020 03:00;9;4;5;Stellenweiser Regenfall;13;14;0
20.07.2020 04:00;9;6;3;Stellenweiser Regenfall;14;15;0
20.07.2020 05:00;51;30;21;Leicht bewölkt;15;15;0
20.07.2020 06:00;204;112;92;Leicht bewölkt;16;16;0
20.07.2020 07:00;816;538;278;Leicht bewölkt;17;18;0
20.07.2020 08:00;797;466;331;Leicht bewölkt;19;19;0
20.07.2020 09:00;721;401;320;Leicht bewölkt;21;21;0
20.07.2020 10:00;813;440;373;Leicht bewölkt;22;22;0
20.07.2020 11:00;837;446;391;Leicht bewölkt;23;24;0
20.07.2020 12:00;974;447;527;Leicht bewölkt;24;26;0
20.07.2020 13:00;1078;489;589;Leicht bewölkt;25;26;0
20.07.2020 14:00;986;478;508;Leicht bewölkt;26;26;0
20.07.2020 15:00;1082;524;558;Leicht bewölkt;26;27;0
20.07.2020 16:00;1207;563;644;Leicht bewölkt;26;26;0
20.07.2020 17:00;1194;554;640;Leicht bewölkt;25;26;0
20.07.2020 18:00;1140;524;616;Leicht bewölkt;24;26;0
20.07.2020 19:00;913;412;501;Leicht bewölkt;23;24;0
20.07.2020 20:00;723;307;416;Stellenweiser Regenfall;21;21;0
20.07.2020 21:00;527;221;306;Stellenweiser Regenfall;20;20;0
20.07.2020 22:00;375;134;241;Stellenweiser Regenfall;19;19;0
20.07.2020 23:00;179;64;115;Leicht bewölkt;18;18;0
21.07.2020 00:00;70;23;47;Leicht bewölkt;17;17;0
21.07.2020 01:00;50;8;42;Leicht bewölkt;16;16;0
21.07.2020 02:00;16;10;6;Leicht bewölkt;15;15;0
21.07.2020 03:00;9;2;7;Leicht bewölkt;14;14;0
21.07.2020 04:00;14;6;8;Leicht bewölkt;15;15;0
21.07.2020 05:00;59;40;19;Leicht bewölkt;16;16;0
21.07.2020 06:00;198;119;79;Leicht bewölkt;17;17;0
21.07.2020 07:00;802;522;280;Leicht bewölkt;18;18;0
21.07.2020 08:00;890;527;363;Leicht bewölkt;20;20;0
21.07.2020 09:00;802;486;316;Leicht bewölkt;21;21;0
21.07.2020 10:00;804;452;352;Leicht bewölkt;22;24;0
21.07.2020 11:00;933;499;434;Stellenweiser Regenfall;24;25;0
21.07.2020 12:00;933;430;503;Stellenweiser Regenfall;25;26;0
21.07.2020 13:00;1086;517;569;Stellenweiser Regenfall;24;26;0
21.07.2020 14:00;979;485;494;Leicht bewölkt;24;26;4
21.07.2020 15:00;1194;549;645;Leicht bewölkt;24;26;5
21.07.2020 16:00;1203;546;657;Leicht bewölkt;23;25;2
21.07.2020 17:00;1301;578;723;Leichter Regenschauer;23;24;1
21.07.2020 18:00;1122;440;682;Leichter Regenschauer;22;22;14
21.07.2020 19:00;695;341;354;Leichter Regenschauer;20;20;7
21.07.2020 20:00;490;213;277;Mäßiger bis starker Regenschauer;19;19;6
21.07.2020 21:00;338;138;200;Mäßiger bis starker Regenschauer;18;18;8
21.07.2020 22:00;273;121;152;Mäßiger bis starker Regenschauer;17;17;4
21.07.2020 23:00;175;63;112;Leichter Regenschauer;16;16;3
22.07.2020 00:00;65;24;41;Leichter Regenschauer;15;15;4
22.07.2020 01:00;44;14;30;Leichter Regenschauer;14;15;2
22.07.2020 02:00;28;13;15;Leichter Regenschauer;14;14;1
22.07.2020 03:00;9;2;7;Leichter Regenschauer;13;14;1
22.07.2020 04:00;11;7;4;Leichter Regenschauer;14;14;1
22.07.2020 05:00;40;28;12;Leichter Nebel;14;15;0
22.07.2020 06:00;201;108;93;Leichter Nebel;15;15;0
22.07.2020 07:00;700;395;305;Leichter Nebel;17;17;0
22.07.2020 08:00;900;551;349;Leichter Regenschauer;18;18;1
22.07.2020 09:00;786;447;339;Leichter Regenschauer;20;20;1
22.07.2020 10:00;798;453;345;Leichter Regenschauer;21;21;0
22.07.2020 11:00;832;463;369;Stellenweiser Regenfall;22;22;3
22.07.2020 12:00;942;431;511;Stellenweiser Regenfall;23;25;4
22.07.2020 13:00;1048;522;526;Stellenweiser Regenfall;23;25;2
22.07.2020 14:00;983;465;518;Stellenweiser Regenfall;23;25;6
22.07.2020 15:00;1030;458;572;Stellenweiser Regenfall;23;25;8
22.07.2020 16:00;1070;521;549;Stellenweiser Regenfall;22;24;4
22.07.2020 17:00;1010;421;589;Stellenweiser Regenfall;22;22;11
22.07.2020 18:00;856;375;481;Stellenweiser Regenfall;21;21;14
22.07.2020 19:00;642;292;350;Stellenweiser Regenfall;20;20;7
22.07.2020 20:00;484;212;272;Mäßiger bis starker Regenschauer;19;19;6
22.07.2020 21:00;362;132;230;Mäßiger bis starker Regenschauer;18;18;8
22.07.2020 22:00;307;123;184;Mäßiger bis starker Regenschauer;17;17;4
22.07.2020 23:00;183;63;120;Stellenweiser Regenfall;16;16;3
23.07.2020 00:00;87;25;62;Stellenweiser Regenfall;15;15;4
23.07.2020 01:00;46;9;37;Stellenweiser Regenfall;15;15;2
23.07.2020 02:00;19;6;13;Stellenweiser Regenfall;14;14;1
23.07.2020 03:00;17;5;12;Stellenweiser Regenfall;14;14;1
23.07.2020 04:00;9;8;1;Stellenweiser Regenfall;14;14;1
23.07.2020 05:00;58;36;22;Leicht bewölkt;15;15;0
23.07.2020 06:00;195;118;77;Leicht bewölkt;16;16;0
23.07.2020 07:00;676;417;259;Leicht bewölkt;18;18;0
23.07.2020 08:00;837;478;359;Leicht bewölkt;20;20;0
23.07.2020 09:00;781;468;313;Leicht bewölkt;22;22;0
23.07.2020 10:00;769;391;378;Leicht bewölkt;23;24;0
23.07.2020 11:00;747;361;386;Stellenweiser Regenfall;24;25;1
23.07.2020 12:00;974;453;521;Stellenweiser Regenfall;25;26;1
23.07.2020 13:00;1054;471;583;Stellenweiser Regenfall;25;26;0
23.07.2020 14:00;1051;538;513;Stellenweiser Regenfall;26;27;1
23.07.2020 15:00;1078;476;602;Stellenweiser Regenfall;26;27;1
23.07.2020 16:00;1165;603;562;Stellenweiser Regenfall;26;27;1
23.07.2020 17:00;1193;547;646;Stellenweiser Regenfall;26;28;2
23.07.2020 18:00;1111;500;611;Stellenweiser Regenfall;25;28;3
23.07.2020 19:00;861;380;481;Stellenweiser Regenfall;25;27;1
23.07.2020 20:00;708;322;386;Stellenweiser Regenfall;24;27;1
23.07.2020 21:00;558;213;345;Stellenweiser Regenfall;23;26;1
23.07.2020 22:00;403;146;257;Stellenweiser Regenfall;21;21;1
23.07.2020 23:00;205;70;135;Stellenweiser Regenfall;18;18;1
24.07.2020 00:00;145;45;100;Stellenweiser Regenfall;16;16;1
24.07.2020 01:00;73;25;48;Stellenweiser Regenfall;15;16;1
24.07.2020 02:00;40;14;26;Nieselregen mit Gewitter;15;15;4
24.07.2020 03:00;27;13;14;Nieselregen mit Gewitter;14;15;5
24.07.2020 04:00;11;4;7;Nieselregen mit Gewitter;15;15;2
24.07.2020 05:00;49;29;20;Leichter Regenschauer;15;16;9
24.07.2020 06:00;177;110;67;Leichter Regenschauer;16;16;12
24.07.2020 07:00;774;469;305;Leichter Regenschauer;17;17;6
24.07.2020 08:00;775;459;316;Mäßiger bis starker Regenschauer;18;18;8
24.07.2020 09:00;746;452;294;Mäßiger bis starker Regenschauer;19;19;11
24.07.2020 10:00;743;423;320;Mäßiger bis starker Regenschauer;19;19;6
24.07.2020 11:00;791;433;358;Stellenweiser Regenfall;20;20;12
24.07.2020 12:00;890;391;499;Stellenweiser Regenfall;20;20;16
24.07.2020 13:00;964;429;535;Stellenweiser Regenfall;20;20;8
24.07.2020 14:00;884;448;436;Mäßiger bis starker Regenschauer;20;20;11
24.07.2020 15:00;1034;517;517;Mäßiger bis starker Regenschauer;21;21;15
24.07.2020 16:00;920;461;459;Mäßiger bis starker Regenschauer;20;20;7
24.07.2020 17:00;919;424;495;Mäßiger bis starker Regenschauer;19;19;13
24.07.2020 18:00;888;399;489;Mäßiger bis starker Regenschauer;19;19;18
24.07.2020 19:00;685;350;335;Mäßiger bis starker Regenschauer;17;18;9
24.07.2020 20:00;568;254;314;Mäßiger bis starker Regenschauer;16;16;8
24.07.2020 21:00;405;170;235;Mäßiger bis starker Regenschauer;15;15;1
24.07.2020 22:00;362;123;239;Mäßiger bis starker Regenschauer;14;15;5
24.07.2020 23:00;258;103;155;Stellenweiser Regenfall;13;14;2
25.07.2020 00:00;205;76;129;Stellenweiser Regenfall;13;13;2
25.07.2020 01:00;130;57;73;Stellenweiser Regenfall;12;13;1
25.07.2020 02:00;93;20;73;Stellenweiser Regenfall;12;12;1
25.07.2020 03:00;60;23;37;Stellenweiser Regenfall;12;12;1
25.07.2020 04:00;29;13;16;Stellenweiser Regenfall;12;13;0
25.07.2020 05:00;32;17;15;Leicht bewölkt;13;13;0
25.07.2020 06:00;55;39;16;Leicht bewölkt;14;14;0
25.07.2020 07:00;111;72;39;Leicht bewölkt;16;16;0
25.07.2020 08:00;270;141;129;Leicht bewölkt;18;18;0
25.07.2020 09:00;553;345;208;Leicht bewölkt;20;20;0
25.07.2020 10:00;736;426;310;Leicht bewölkt;21;21;0
25.07.2020 11:00;844;449;395;Leicht bewölkt;22;24;0
25.07.2020 12:00;923;438;485;Leicht bewölkt;24;25;0
25.07.2020 13:00;828;394;434;Leicht bewölkt;24;26;0
25.07.2020 14:00;912;424;488;Leicht bewölkt;25;26;0
25.07.2020 15:00;815;394;421;Leicht bewölkt;25;26;0
25.07.2020 16:00;763;364;399;Leicht bewölkt;24;25;0
25.07.2020 17:00;817;387;430;Leicht bewölkt;23;24;0
25.07.2020 18:00;797;381;416;Leicht bewölkt;22;22;0
25.07.2020 19:00;824;396;428;Leicht bewölkt;21;21;0
25.07.2020 20:00;643;341;302;Leicht bewölkt;19;19;0
25.07.2020 21:00;476;217;259;Leicht bewölkt;18;18;0
25.07.2020 22:00;355;143;212;Leicht bewölkt;17;17;0
25.07.2020 23:00;309;117;192;Leicht bewölkt;16;16;0
26.07.2020 00:00;243;101;142;Leicht bewölkt;15;16;0
26.07.2020 01:00;178;63;115;Leicht bewölkt;15;15;0
26.07.2020 02:00;82;28;54;Leicht bewölkt;15;15;0
26.07.2020 03:00;57;22;35;Leicht bewölkt;14;15;0
26.07.2020 04:00;33;13;20;Leicht bewölkt;15;16;0
26.07.2020 05:00;38;19;19;Stellenweiser Regenfall;16;16;0
26.07.2020 06:00;43;29;14;Stellenweiser Regenfall;17;17;0
26.07.2020 07:00;29;19;10;Stellenweiser Regenfall;18;18;0
26.07.2020 08:00;92;46;46;Leicht bewölkt;19;19;2
26.07.2020 09:00;221;117;104;Leicht bewölkt;20;20;3
26.07.2020 10:00;358;186;172;Leicht bewölkt;21;21;2
26.07.2020 11:00;502;255;247;Leichter Regenschauer;22;22;1
26.07.2020 12:00;461;230;231;Leichter Regenschauer;23;24;1
26.07.2020 13:00;574;273;301;Leichter Regenschauer;23;24;1
26.07.2020 14:00;632;302;330;Leicht bewölkt;23;25;2
26.07.2020 15:00;655;348;307;Leicht bewölkt;24;25;3
26.07.2020 16:00;628;302;326;Leicht bewölkt;23;24;2
26.07.2020 17:00;714;365;349;Stellenweiser Regenfall;22;22;1
26.07.2020 18:00;661;337;324;Stellenweiser Regenfall;21;21;1
26.07.2020 19:00;450;198;252;Stellenweiser Regenfall;20;20;1
26.07.2020 20:00;387;181;206;Leicht bewölkt;18;18;0
26.07.2020 21:00;313;135;178;Leicht bewölkt;17;17;0
26.07.2020 22:00;187;49;138;Leicht bewölkt;16;16;0
26.07.2020 23:00;116;50;66;Stellenweiser Regenfall;15;15;1
27.07.2020 00:00;59;15;44;Stellenweiser Regenfall;14;15;1
27.07.2020 01:00;19;7;12;Stellenweiser Regenfall;14;14;0
27.07.2020 02:00;8;3;5;Stellenweiser Regenfall;13;14;0
27.07.2020 03:00;5;3;2;Stellenweiser Regenfall;13;14;0
27.07.2020 04:00;9;4;5;Stellenweiser Regenfall;14;14;0
27.07.2020 05:00;41;23;18;Leicht bewölkt;15;15;0
27.07.2020 06:00;190;104;86;Leicht bewölkt;16;16;0
27.07.2020 07:00;746;499;247;Leicht bewölkt;18;18;0
27.07.2020 08:00;834;459;375;Leicht bewölkt;20;20;0
27.07.2020 09:00;728;415;313;Leicht bewölkt;22;23;0
27.07.2020 10:00;895;468;427;Leicht bewölkt;24;24;0
27.07.2020 11:00;886;455;431;Leicht bewölkt;25;26;0
27.07.2020 12:00;1088;507;581;Leicht bewölkt;27;27;0
27.07.2020 13:00;1019;435;584;Leicht bewölkt;27;28;0
27.07.2020 14:00;1020;480;540;Leicht bewölkt;27;28;0
27.07.2020 15:00;1070;534;536;Leicht bewölkt;28;29;0
27.07.2020 16:00;1169;513;656;Leicht bewölkt;27;28;0
27.07.2020 17:00;1245;559;686;Leicht bewölkt;26;27;0
27.07.2020 18:00;1136;547;589;Leicht bewölkt;25;26;0
27.07.2020 19:00;926;451;475;Leicht bewölkt;23;24;0
27.07.2020 20:00;722;322;400;Leicht bewölkt;22;22;0
27.07.2020 21:00;606;246;360;Leicht bewölkt;20;20;0
27.07.2020 22:00;402;168;234;Leicht bewölkt;20;20;0
27.07.2020 23:00;227;84;143;Leicht bewölkt;19;19;0
28.07.2020 00:00;142;49;93;Leicht bewölkt;19;19;0
28.07.2020 01:00;64;19;45;Leicht bewölkt;18;18;0
28.07.2020 02:00;22;8;14;Leicht bewölkt;18;18;0
28.07.2020 03:00;28;9;19;Leicht bewölkt;17;17;0
28.07.2020 04:00;15;6;9;Leicht bewölkt;18;18;0
28.07.2020 05:00;44;25;19;Leicht bewölkt;18;18;0
28.07.2020 06:00;210;126;84;Leicht bewölkt;19;19;0
28.07.2020 07:00;792;520;272;Leicht bewölkt;21;21;0
28.07.2020 08:00;885;496;389;Leicht bewölkt;23;23;0
28.07.2020 09:00;946;536;410;Leicht bewölkt;24;25;0
28.07.2020 10:00;872;438;434;Leicht bewölkt;25;26;0
28.07.2020 11:00;929;458;471;Leicht bewölkt;27;28;0
28.07.2020 12:00;1048;430;618;Leicht bewölkt;28;29;0
28.07.2020 13:00;895;427;468;Leicht bewölkt;28;29;0
28.07.2020 14:00;863;470;393;Leicht bewölkt;28;29;0
28.07.2020 15:00;872;389;483;Leicht bewölkt;28;29;0
28.07.2020 16:00;904;423;481;Leicht bewölkt;27;29;0
28.07.2020 17:00;1092;534;558;Leicht bewölkt;27;29;3
28.07.2020 18:00;891;405;486;Leicht bewölkt;26;30;4
28.07.2020 19:00;686;321;365;Leicht bewölkt;25;28;2
28.07.2020 20:00;479;197;282;Nieselregen mit Gewitter;25;27;5
28.07.2020 21:00;407;165;242;Nieselregen mit Gewitter;24;26;7
28.07.2020 22:00;272;113;159;Nieselregen mit Gewitter;21;21;3
28.07.2020 23:00;179;83;96;Mäßiger bis starker Regenschauer;19;19;12
29.07.2020 00:00;124;48;76;Mäßiger bis starker Regenschauer;17;17;16
29.07.2020 01:00;65;22;43;Mäßiger bis starker Regenschauer;16;16;8
29.07.2020 02:00;20;5;15;Mäßiger bis starker Regenschauer;16;16;6
29.07.2020 03:00;21;14;7;Mäßiger bis starker Regenschauer;15;16;8
29.07.2020 04:00;16;10;6;Mäßiger bis starker Regenschauer;16;16;4
29.07.2020 05:00;61;27;34;Nieselregen;16;16;3
29.07.2020 06:00;212;134;78;Nieselregen;16;16;4
29.07.2020 07:00;665;408;257;Nieselregen;17;17;2
29.07.2020 08:00;925;543;382;Leichter Regenfall;18;18;1
29.07.2020 09:00;951;570;381;Leichter Regenfall;19;19;1
29.07.2020 10:00;759;383;376;Leichter Regenfall;21;21;1
29.07.2020 11:00;943;497;446;Leicht bewölkt;22;23;0
29.07.2020 12:00;1000;403;597;Leicht bewölkt;23;24;0
29.07.2020 13:00;938;442;496;Leicht bewölkt;24;25;0
29.07.2020 14:00;1035;505;530;Bewölkt;25;26;0
29.07.2020 15:00;1096;513;583;Bewölkt;25;26;0
29.07.2020 16:00;1146;559;587;Bewölkt;24;26;0
29.07.2020 17:00;1314;633;681;Leicht bewölkt;23;25;0
29.07.2020 18:00;1263;567;696;Leicht bewölkt;23;25;0
29.07.2020 19:00;995;449;546;Leicht bewölkt;21;21;0
29.07.2020 20:00;758;342;416;Leicht bewölkt;20;20;0
29.07.2020 21:00;589;233;356;Leicht bewölkt;18;18;0
29.07.2020 22:00;445;169;276;Leicht bewölkt;17;17;0
29.07.2020 23:00;282;100;182;Leicht bewölkt;16;16;0
30.07.2020 00:00;175;64;111;Leicht bewölkt;15;15;0
30.07.2020 01:00;101;29;72;Leicht bewölkt;14;15;0
30.07.2020 02:00;54;25;29;Leicht bewölkt;14;14;0
30.07.2020 03:00;35;9;26;Leicht bewölkt;13;14;0
30.07.2020 04:00;13;8;5;Leicht bewölkt;14;14;0
30.07.2020 05:00;53;27;26;Leichter Nebel;15;15;0
30.07.2020 06:00;176;103;73;Leichter Nebel;15;16;0
30.07.2020 07:00;495;312;183;Leichter Nebel;17;17;0
30.07.2020 08:00;797;438;359;Leicht bewölkt;19;19;0
30.07.2020 09:00;766;426;340;Leicht bewölkt;21;21;0
30.07.2020 10:00;769;437;332;Leicht bewölkt;23;24;0
30.07.2020 11:00;778;408;370;Leicht bewölkt;25;26;0
30.07.2020 12:00;955;421;534;Leicht bewölkt;26;28;0
30.07.2020 13:00;895;405;490;Leicht bewölkt;26;28;0
30.07.2020 14:00;972;467;505;Leicht bewölkt;27;28;0
30.07.2020 15:00;935;454;481;Leicht bewölkt;27;29;0
30.07.2020 16:00;1048;521;527;Leicht bewölkt;26;28;0
30.07.2020 17:00;1122;534;588;Leicht bewölkt;25;27;0
30.07.2020 18:00;1173;537;636;Leicht bewölkt;24;26;0
30.07.2020 19:00;865;353;512;Leicht bewölkt;23;24;0
30.07.2020 20:00;696;327;369;Leicht bewölkt;21;21;0
30.07.2020 21:00;598;234;364;Leicht bewölkt;20;20;0
30.07.2020 22:00;475;178;297;Leicht bewölkt;20;20;0
30.07.2020 23:00;282;110;172;Leicht bewölkt;19;19;0
31.07.2020 00:00;183;86;97;Leicht bewölkt;19;19;0
31.07.2020 01:00;83;21;62;Leicht bewölkt;18;18;0
31.07.2020 02:00;50;20;30;Leicht bewölkt;18;18;0
31.07.2020 03:00;28;8;20;Leicht bewölkt;17;17;0
31.07.2020 04:00;17;4;13;Leicht bewölkt;18;18;0
31.07.2020 05:00;53;29;24;Leicht bewölkt;19;19;0
31.07.2020 06:00;177;109;68;Leicht bewölkt;19;19;0
31.07.2020 07:00;474;279;195;Leicht bewölkt;21;21;0
31.07.2020 08:00;722;428;294;Stellenweiser Regenfall;23;23;0
31.07.2020 09:00;802;479;323;Stellenweiser Regenfall;24;25;0
31.07.2020 10:00;796;440;356;Stellenweiser Regenfall;26;27;0
31.07.2020 11:00;910;418;492;Leicht bewölkt;27;29;0
31.07.2020 12:00;923;396;527;Leicht bewölkt;29;31;0
31.07.2020 13:00;877;387;490;Leicht bewölkt;30;32;0
31.07.2020 14:00;890;455;435;Leicht bewölkt;30;32;0
31.07.2020 15:00;941;444;497;Leicht bewölkt;31;33;0
31.07.2020 16:00;898;444;454;Leicht bewölkt;30;32;0
31.07.2020 17:00;901;404;497;Leicht bewölkt;29;32;0
31.07.2020 18:00;1007;499;508;Leicht bewölkt;29;31;0
31.07.2020 19:00;798;398;400;Leicht bewölkt;27;29;0
31.07.2020 20:00;700;326;374;Stellenweiser Regenfall;26;28;0
31.07.2020 21:00;562;222;340;Stellenweiser Regenfall;25;27;0
31.07.2020 22:00;440;215;225;Stellenweiser Regenfall;23;25;0
31.07.2020 23:00;356;157;199;Stellenweiser Regenfall;22;23;1
01.08.2020 00:00;214;60;154;Stellenweiser Regenfall;21;21;1
01.08.2020 01:00;144;61;83;Stellenweiser Regenfall;20;20;0
01.08.2020 02:00;104;28;76;Stellenweiser Regenfall;19;19;0
01.08.2020 03:00;56;15;41;Stellenweiser Regenfall;19;19;0
01.08.2020 04:00;41;11;30;Stellenweiser Regenfall;19;19;0
01.08.2020 05:00;43;24;19;Leicht bewölkt;20;20;0
01.08.2020 06:00;64;31;33;Leicht bewölkt;20;20;0
01.08.2020 07:00;134;71;63;Leicht bewölkt;22;22;0
01.08.2020 08:00;346;227;119;Stellenweiser Regenfall;24;24;0
01.08.2020 09:00;605;360;245;Stellenweiser Regenfall;25;27;0
01.08.2020 10:00;753;389;364;Stellenweiser Regenfall;27;28;0
01.08.2020 11:00;786;372;414;Leicht bewölkt;28;30;0
01.08.2020 12:00;699;361;338;Leicht bewölkt;30;31;0
01.08.2020 13:00;651;323;328;Leicht bewölkt;30;32;0
01.08.2020 14:00;650;281;369;Leicht bewölkt;30;32;0
01.08.2020 15:00;684;321;363;Leicht bewölkt;31;33;0
01.08.2020 16:00;701;318;383;Leicht bewölkt;30;32;0
01.08.2020 17:00;722;339;383;Stellenweise Gewitter und Niederschläge;29;31;21
01.08.2020 18:00;648;298;350;Stellenweise Gewitter und Niederschläge;28;30;28
01.08.2020 19:00;537;259;278;Stellenweise Gewitter und Niederschläge;27;29;14
01.08.2020 20:00;494;234;260;Starker Regenfall;26;28;3
01.08.2020 21:00;425;210;215;Starker Regenfall;25;27;4
01.08.2020 22:00;326;110;216;Starker Regenfall;23;25;2
01.08.2020 23:00;298;118;180;Leichter Regenschauer;21;21;1
02.08.2020 00:00;221;89;132;Leichter Regenschauer;19;19;3
02.08.2020 01:00;151;64;87;Leichter Regenschauer;18;18;1
02.08.2020 02:00;77;30;47;Leicht bewölkt;17;17;1
02.08.2020 03:00;58;23;35;Leicht bewölkt;16;16;1
02.08.2020 04:00;43;14;29;Leicht bewölkt;16;16;1
02.08.2020 05:00;25;13;12;Stellenweiser Regenfall;16;16;3
02.08.2020 06:00;35;15;20;Stellenweiser Regenfall;17;17;4
02.08.2020 07:00;42;26;16;Stellenweiser Regenfall;17;17;2
02.08.2020 08:00;120;62;58;Leichter Regenschauer;18;18;4
02.08.2020 09:00;256;167;89;Leichter Regenschauer;19;19;5
02.08.2020 10:00;357;202;155;Leichter Regenschauer;20;20;3
02.08.2020 11:00;433;221;212;Leichter Regenschauer;21;21;16
02.08.2020 12:00;477;243;234;Leichter Regenschauer;22;22;21
02.08.2020 13:00;416;198;218;Leichter Regenschauer;22;22;1
02.08.2020 14:00;507;248;259;Mäßiger bis starker Regenschauer;21;21;18
02.08.2020 15:00;446;203;243;Mäßiger bis starker Regenschauer;21;21;24
02.08.2020 16:00;421;190;231;Mäßiger bis starker Regenschauer;21;21;12
02.08.2020 17:00;208;90;118;Mäßiger bis starker Regenschauer;20;20;23
02.08.2020 18:00;254;124;130;Mäßiger bis starker Regenschauer;19;19;31
02.08.2020 19:00;231;136;95;Mäßiger bis starker Regenschauer;18;18;15
02.08.2020 20:00;176;81;95;Sintflutartiger Regenfall;17;17;17
02.08.2020 21:00;169;87;82;Sintflutartiger Regenfall;16;16;23
02.08.2020 22:00;84;33;51;Sintflutartiger Regenfall;16;16;12
02.08.2020 23:00;56;22;34;Teilweise mäßiger Regenfall;16;16;27
03.08.2020 00:00;33;11;22;Teilweise mäßiger Regenfall;16;16;36
03.08.2020 01:00;17;7;10;Teilweise mäßiger Regenfall;15;15;18
03.08.2020 02:00;15;3;12;Teilweise starker Regenfall;15;15;12
03.08.2020 03:00;5;2;3;Teilweise starker Regenfall;15;15;16
03.08.2020 04:00;9;3;6;Teilweise starker Regenfall;15;15;8
03.08.2020 05:00;46;23;23;Stellenweiser leichter Regenfall;16;16;2
03.08.2020 06:00;145;94;51;Stellenweiser leichter Regenfall;16;16;3
03.08.2020 07:00;405;236;169;Stellenweiser leichter Regenfall;16;16;2
03.08.2020 08:00;522;304;218;Nieselregen;16;16;5
03.08.2020 09:00;552;325;227;Nieselregen;16;16;6
03.08.2020 10:00;595;341;254;Nieselregen;16;16;3
03.08.2020 11:00;543;286;257;Leichter Regenschauer;16;16;16
03.08.2020 12:00;630;305;325;Leichter Regenschauer;16;15;21
03.08.2020 13:00;471;240;231;Leichter Regenschauer;15;15;1
03.08.2020 14:00;520;245;275;Mäßiger Regenfall;15;14;31
03.08.2020 15:00;593;262;331;Mäßiger Regenfall;14;14;41
03.08.2020 16:00;547;243;304;Mäßiger Regenfall;14;13;21
03.08.2020 17:00;490;202;288;Starker Regenfall;13;13;43
03.08.2020 18:00;367;145;222;Starker Regenfall;13;12;58
03.08.2020 19:00;278;134;144;Starker Regenfall;12;12;29
03.08.2020 20:00;182;82;100;Starker Regenfall;12;12;2
03.08.2020 21:00;148;68;80;Starker Regenfall;12;12;27
03.08.2020 22:00;87;42;45;Starker Regenfall;12;11;14
03.08.2020 23:00;66;31;35;Starker Regenfall;12;11;51
04.08.2020 00:00;50;21;29;Starker Regenfall;12;11;68
04.08.2020 01:00;31;8;23;Starker Regenfall;12;11;34
04.08.2020 02:00;7;3;4;Starker Regenfall;12;11;36
04.08.2020 03:00;11;1;10;Starker Regenfall;13;12;48
04.08.2020 04:00;6;3;3;Starker Regenfall;13;12;24
04.08.2020 05:00;32;18;14;Starker Regenfall;13;12;21
04.08.2020 06:00;104;55;49;Starker Regenfall;13;12;28
04.08.2020 07:00;244;150;94;Starker Regenfall;13;13;14
04.08.2020 08:00;402;235;167;Teilweise mäßiger Regenfall;13;13;8
04.08.2020 09:00;361;208;153;Teilweise mäßiger Regenfall;14;13;11
04.08.2020 10:00;426;235;191;Teilweise mäßiger Regenfall;14;13;5
04.08.2020 11:00;463;263;200;Stellenweiser leichter Regenfall;14;14;1
04.08.2020 12:00;535;272;263;Stellenweiser leichter Regenfall;14;14;1
04.08.2020 13:00;448;223;225;Stellenweiser leichter Regenfall;15;15;1
04.08.2020 14:00;530;283;247;Leicht bewölkt;16;15;0
04.08.2020 15:00;629;334;295;Leicht bewölkt;17;16;0
04.08.2020 16:00;661;338;323;Leicht bewölkt;16;16;0
04.08.2020 17:00;835;419;416;Bewölkt;16;16;0
04.08.2020 18:00;772;332;440;Bewölkt;16;16;0
04.08.2020 19:00;591;253;338;Bewölkt;15;15;0
04.08.2020 20:00;416;177;239;Leicht bewölkt;14;14;0
04.08.2020 21:00;335;152;183;Leicht bewölkt;14;14;0
04.08.2020 22:00;230;91;139;Leicht bewölkt;12;12;0
04.08.2020 23:00;159;64;95;Leicht bewölkt;11;11;0
05.08.2020 00:00;99;51;48;Leicht bewölkt;9;9;0
05.08.2020 01:00;50;18;32;Leicht bewölkt;9;9;0
05.08.2020 02:00;28;14;14;Leicht bewölkt;9;9;0
05.08.2020 03:00;8;2;6;Leicht bewölkt;8;8;0
05.08.2020 04:00;21;9;12;Leicht bewölkt;9;9;0
05.08.2020 05:00;40;24;16;Leichter Nebel;10;10;0
05.08.2020 06:00;184;109;75;Leichter Nebel;11;11;0
05.08.2020 07:00;483;297;186;Leichter Nebel;12;12;0
05.08.2020 08:00;653;390;263;Leicht bewölkt;14;14;0
05.08.2020 09:00;691;404;287;Leicht bewölkt;16;16;0
05.08.2020 10:00;709;413;296;Leicht bewölkt;17;17;0
05.08.2020 11:00;755;366;389;Leicht bewölkt;18;18;0
05.08.2020 12:00;902;420;482;Leicht bewölkt;20;20;0
05.08.2020 13:00;833;427;406;Leicht bewölkt;20;20;0
05.08.2020 14:00;973;502;471;Leicht bewölkt;21;21;0
05.08.2020 15:00;1091;526;565;Leicht bewölkt;21;21;0
05.08.2020 16:00;1081;546;535;Leicht bewölkt;21;21;0
05.08.2020 17:00;1254;602;652;Leicht bewölkt;20;20;0
05.08.2020 18:00;1158;549;609;Leicht bewölkt;20;20;0
05.08.2020 19:00;859;416;443;Leicht bewölkt;18;18;0
05.08.2020 20:00;629;287;342;Leicht bewölkt;17;17;0
05.08.2020 21:00;539;224;315;Leicht bewölkt;16;16;0
05.08.2020 22:00;362;164;198;Leicht bewölkt;15;15;0
05.08.2020 23:00;206;62;144;Leicht bewölkt;13;13;0
06.08.2020 00:00;112;42;70;Leicht bewölkt;12;12;0
06.08.2020 01:00;76;35;41;Leicht bewölkt;11;12;0
06.08.2020 02:00;37;8;29;Leichter Nebel;11;11;0
06.08.2020 03:00;37;8;29;Leichter Nebel;10;11;0
06.08.2020 04:00;14;9;5;Leichter Nebel;11;11;0
06.08.2020 05:00;56;32;24;Leichter Nebel;12;12;0
06.08.2020 06:00;178;109;69;Leichter Nebel;12;13;0
06.08.2020 07:00;444;273;171;Leichter Nebel;14;14;0
06.08.2020 08:00;689;416;273;Leicht bewölkt;16;16;0
06.08.2020 09:00;668;362;306;Leicht bewölkt;18;18;0
06.08.2020 10:00;737;407;330;Leicht bewölkt;19;19;0
06.08.2020 11:00;737;360;377;Leicht bewölkt;21;21;0
06.08.2020 12:00;872;418;454;Leicht bewölkt;22;24;0
06.08.2020 13:00;881;417;464;Leicht bewölkt;23;24;0
06.08.2020 14:00;880;438;442;Sonnig;23;25;0
06.08.2020 15:00;954;457;497;Sonnig;24;26;0
06.08.2020 16:00;1043;522;521;Sonnig;23;24;0
06.08.2020 17:00;1048;468;580;Leicht bewölkt;22;22;0
06.08.2020 18:00;1090;499;591;Leicht bewölkt;21;21;0
06.08.2020 19:00;858;404;454;Leicht bewölkt;20;20;0
06.08.2020 20:00;606;271;335;Leicht bewölkt;18;18;0
06.08.2020 21:00;562;244;318;Leicht bewölkt;17;17;0
06.08.2020 22:00;393;142;251;Leicht bewölkt;16;16;0
06.08.2020 23:00;275;98;177;Leicht bewölkt;16;16;0
07.08.2020 00:00;146;50;96;Leicht bewölkt;15;15;0
07.08.2020 01:00;50;25;25;Leicht bewölkt;14;14;0
07.08.2020 02:00;48;13;35;Leichter Nebel;14;14;0
07.08.2020 03:00;30;12;18;Leichter Nebel;14;14;0
07.08.2020 04:00;15;4;11;Leichter Nebel;14;14;0
07.08.2020 05:00;45;22;23;Leichter Nebel;15;15;0
07.08.2020 06:00;168;105;63;Leichter Nebel;16;16;0
07.08.2020 07:00;474;284;190;Leichter Nebel;17;17;0
07.08.2020 08:00;654;403;251;Leicht bewölkt;19;19;0
07.08.2020 09:00;741;454;287;Leicht bewölkt;20;20;0
07.08.2020 10:00;822;433;389;Leicht bewölkt;21;21;0
07.08.2020 11:00;807;436;371;Leicht bewölkt;22;24;0
07.08.2020 12:00;871;379;492;Leicht bewölkt;23;25;0
07.08.2020 13:00;935;433;502;Leicht bewölkt;24;26;0
07.08.2020 14:00;880;443;437;Leicht bewölkt;24;26;0
07.08.2020 15:00;873;401;472;Leicht bewölkt;25;26;0
07.08.2020 16:00;802;403;399;Leicht bewölkt;24;26;0
07.08.2020 17:00;913;428;485;Leicht bewölkt;23;25;0
07.08.2020 18:00;927;459;468;Leicht bewölkt;22;25;0
07.08.2020 19:00;754;343;411;Leicht bewölkt;21;21;0
07.08.2020 20:00;713;323;390;Leicht bewölkt;21;21;0
07.08.2020 21:00;474;207;267;Leicht bewölkt;20;20;0
07.08.2020 22:00;376;135;241;Leicht bewölkt;19;19;0
07.08.2020 23:00;293;132;161;Sonnig;18;18;0
08.08.2020 00:00;206;70;136;Sonnig;17;17;0
08.08.2020 01:00;149;55;94;Sonnig;17;17;0
08.08.2020 02:00;76;26;50;Leicht bewölkt;16;16;0
08.08.2020 03:00;47;14;33;Leicht bewölkt;15;15;0
08.08.2020 04:00;38;19;19;Leicht bewölkt;16;16;0
08.08.2020 05:00;44;24;20;Leichter Nebel;16;16;0
08.08.2020 06:00;67;42;25;Leichter Nebel;17;17;0
08.08.2020 07:00;109;49;60;Leichter Nebel;19;19;0
08.08.2020 08:00;304;170;134;Leicht bewölkt;21;21;0
08.08.2020 09:00;570;349;221;Leicht bewölkt;23;24;0
08.08.2020 10:00;704;387;317;Leicht bewölkt;24;26;0
08.08.2020 11:00;702;381;321;Leicht bewölkt;26;28;0
08.08.2020 12:00;633;271;362;Leicht bewölkt;28;30;0
08.08.2020 13:00;666;340;326;Leicht bewölkt;28;30;0
08.08.2020 14:00;715;353;362;Sonnig;28;30;0
08.08.2020 15:00;654;337;317;Sonnig;28;30;0
08.08.2020 16:00;641;303;338;Sonnig;27;29;0
08.08.2020 17:00;739;374;365;Sonnig;26;28;0
08.08.2020 18:00;676;325;351;Sonnig;25;27;0
08.08.2020 19:00;653;301;352;Sonnig;24;25;0
08.08.2020 20:00;529;267;262;Sonnig;22;23;0
08.08.2020 21:00;354;152;202;Sonnig;21;21;0
08.08.2020 22:00;341;163;178;Sonnig;20;20;0
08.08.2020 23:00;267;115;152;Sonnig;19;19;0
09.08.2020 00:00;196;67;129;Sonnig;19;19;0
09.08.2020 01:00;165;58;107;Sonnig;18;18;0
09.08.2020 02:00;116;41;75;Leicht bewölkt;17;17;0
09.08.2020 03:00;54;14;40;Leicht bewölkt;16;16;0
09.08.2020 04:00;31;13;18;Leicht bewölkt;17;17;0
09.08.2020 05:00;26;12;14;Leicht bewölkt;17;17;0
09.08.2020 06:00;51;32;19;Leicht bewölkt;18;18;0
09.08.2020 07:00;64;33;31;Leicht bewölkt;20;20;0
09.08.2020 08:00;181;104;77;Leicht bewölkt;22;22;0
09.08.2020 09:00;327;165;162;Leicht bewölkt;24;25;0
09.08.2020 10:00;456;226;230;Leicht bewölkt;25;26;0
09.08.2020 11:00;473;224;249;Sonnig;26;28;0
09.08.2020 12:00;445;213;232;Sonnig;27;29;0
09.08.2020 13:00;489;217;272;Sonnig;28;29;0
09.08.2020 14:00;487;210;277;Sonnig;28;30;0
09.08.2020 15:00;500;249;251;Sonnig;28;30;0
09.08.2020 16:00;469;231;238;Sonnig;27;29;0
09.08.2020 17:00;591;252;339;Leicht bewölkt;27;29;0
09.08.2020 18:00;634;317;317;Leicht bewölkt;26;28;0
09.08.2020 19:00;599;295;304;Leicht bewölkt;25;27;0
09.08.2020 20:00;426;212;214;Leicht bewölkt;24;27;0
09.08.2020 21:00;356;129;227;Leicht bewölkt;23;26;0
09.08.2020 22:00;252;98;154;Leicht bewölkt;22;25;0
09.08.2020 23:00;153;55;98;Leicht bewölkt;21;21;0
10.08.2020 00:00;73;22;51;Leicht bewölkt;20;20;0
10.08.2020 01:00;25;13;12;Leicht bewölkt;19;19;0
10.08.2020 02:00;21;13;8;Leicht bewölkt;18;18;0
10.08.2020 03:00;11;4;7;Leicht bewölkt;17;17;0
10.08.2020 04:00;7;4;3;Leicht bewölkt;17;17;0
10.08.2020 05:00;46;27;19;Leicht bewölkt;18;18;0
10.08.2020 06:00;200;125;75;Leicht bewölkt;18;18;0
10.08.2020 07:00;406;238;168;Leicht bewölkt;20;20;0
10.08.2020 08:00;605;361;244;Leicht bewölkt;22;22;0
10.08.2020 09:00;613;354;259;Leicht bewölkt;23;25;0
10.08.2020 10:00;642;328;314;Leicht bewölkt;25;26;0
10.08.2020 11:00;732;394;338;Leicht bewölkt;26;28;0
10.08.2020 12:00;734;333;401;Leicht bewölkt;28;30;0
10.08.2020 13:00;718;335;383;Leicht bewölkt;28;30;0
10.08.2020 14:00;789;373;416;Leicht bewölkt;28;30;0
10.08.2020 15:00;818;429;389;Leicht bewölkt;28;30;0
10.08.2020 16:00;826;410;416;Leicht bewölkt;27;29;0
10.08.2020 17:00;1011;474;537;Leicht bewölkt;26;28;0
10.08.2020 18:00;920;442;478;Leicht bewölkt;25;27;0
10.08.2020 19:00;740;334;406;Leicht bewölkt;23;25;0
10.08.2020 20:00;613;238;375;Leicht bewölkt;22;23;0
10.08.2020 21:00;437;177;260;Leicht bewölkt;21;21;0
10.08.2020 22:00;245;93;152;Leicht bewölkt;20;20;0
10.08.2020 23:00;161;59;102;Stellenweiser Regenfall;19;19;2
11.08.2020 00:00;87;36;51;Stellenweiser Regenfall;19;19;2
11.08.2020 01:00;45;21;24;Stellenweiser Regenfall;18;18;1
11.08.2020 02:00;26;10;16;Stellenweiser Regenfall;17;17;2
11.08.2020 03:00;22;5;17;Stellenweiser Regenfall;17;17;2
11.08.2020 04:00;10;8;2;Stellenweiser Regenfall;17;17;1
11.08.2020 05:00;48;31;17;Stellenweiser Regenfall;18;18;2
11.08.2020 06:00;206;119;87;Stellenweiser Regenfall;18;18;2
11.08.2020 07:00;412;233;179;Stellenweiser Regenfall;20;20;1
11.08.2020 08:00;630;374;256;Stellenweiser Regenfall;22;22;1
11.08.2020 09:00;719;423;296;Stellenweiser Regenfall;24;25;1
11.08.2020 10:00;726;374;352;Stellenweiser Regenfall;25;26;0
11.08.2020 11:00;790;419;371;Stellenweiser Regenfall;26;28;0
11.08.2020 12:00;781;355;426;Stellenweiser Regenfall;28;30;0
11.08.2020 13:00;650;308;342;Stellenweiser Regenfall;28;30;0
11.08.2020 14:00;790;382;408;Leicht bewölkt;29;30;1
11.08.2020 15:00;779;388;391;Leicht bewölkt;29;31;1
11.08.2020 16:00;843;429;414;Leicht bewölkt;28;31;1
11.08.2020 17:00;988;470;518;Nieselregen mit Gewitter;28;31;0
11.08.2020 18:00;953;399;554;Nieselregen mit Gewitter;28;31;0
11.08.2020 19:00;774;352;422;Nieselregen mit Gewitter;27;30;0
11.08.2020 20:00;588;237;351;Leicht bewölkt;26;29;0
11.08.2020 21:00;467;217;250;Leicht bewölkt;26;28;0
11.08.2020 22:00;279;108;171;Leicht bewölkt;23;25;0
11.08.2020 23:00;192;69;123;Stellenweiser Regenfall;21;21;4
12.08.2020 00:00;73;18;55;Stellenweiser Regenfall;19;19;5
12.08.2020 01:00;55;17;38;Stellenweiser Regenfall;19;19;3
12.08.2020 02:00;40;21;19;Stellenweiser Regenfall;18;18;4
12.08.2020 03:00;21;9;12;Stellenweiser Regenfall;17;17;5
12.08.2020 04:00;15;9;6;Stellenweiser Regenfall;18;18;2
12.08.2020 05:00;51;26;25;Stellenweiser Regenfall;19;19;5
12.08.2020 06:00;184;111;73;Stellenweiser Regenfall;19;19;6
12.08.2020 07:00;484;273;211;Stellenweiser Regenfall;21;21;3
12.08.2020 08:00;557;326;231;Stellenweiser Regenfall;23;23;2
12.08.2020 09:00;666;397;269;Stellenweiser Regenfall;25;26;2
12.08.2020 10:00;648;344;304;Stellenweiser Regenfall;26;27;1
12.08.2020 11:00;736;400;336;Leicht bewölkt;27;29;0
12.08.2020 12:00;768;360;408;Leicht bewölkt;29;31;0
12.08.2020 13:00;679;321;358;Leicht bewölkt;29;31;0
12.08.2020 14:00;770;379;391;Leicht bewölkt;29;31;0
12.08.2020 15:00;748;392;356;Leicht bewölkt;29;32;0
12.08.2020 16:00;877;439;438;Leicht bewölkt;28;31;0
12.08.2020 17:00;963;446;517;Leicht bewölkt;27;30;1
12.08.2020 18:00;960;447;513;Leicht bewölkt;27;29;1
12.08.2020 19:00;720;293;427;Leicht bewölkt;26;28;1
12.08.2020 20:00;633;248;385;Stellenweiser Regenfall;25;27;1
12.08.2020 21:00;384;152;232;Stellenweiser Regenfall;24;26;1
12.08.2020 22:00;310;107;203;Stellenweiser Regenfall;23;24;0
12.08.2020 23:00;178;65;113;Leicht bewölkt;21;21;0
13.08.2020 00:00;132;64;68;Leicht bewölkt;20;20;0
13.08.2020 01:00;104;45;59;Leicht bewölkt;19;19;0
13.08.2020 02:00;29;8;21;Leicht bewölkt;19;19;0
13.08.2020 03:00;16;2;14;Leicht bewölkt;18;18;0
13.08.2020 04:00;20;8;12;Leicht bewölkt;18;18;0
13.08.2020 05:00;55;30;25;Leicht bewölkt;18;18;0
13.08.2020 06:00;188;108;80;Leicht bewölkt;19;19;0
13.08.2020 07:00;332;193;139;Leicht bewölkt;20;20;0
13.08.2020 08:00;509;329;180;Stellenweiser Regenfall;21;21;2
13.08.2020 09:00;473;285;188;Stellenweiser Regenfall;22;24;3
13.08.2020 10:00;555;317;238;Stellenweiser Regenfall;23;25;1
13.08.2020 11:00;588;317;271;Stellenweiser Regenfall;24;26;6
13.08.2020 12:00;681;333;348;Stellenweiser Regenfall;25;27;8
13.08.2020 13:00;660;333;327;Stellenweiser Regenfall;24;26;4
13.08.2020 14:00;782;377;405;Nieselregen mit Gewitter;24;26;16
13.08.2020 15:00;867;397;470;Nieselregen mit Gewitter;24;26;21
13.08.2020 16:00;671;329;342;Nieselregen mit Gewitter;23;25;11
13.08.2020 17:00;631;281;350;Mäßiger bis starker Regenschauer;22;23;23
13.08.2020 18:00;720;322;398;Mäßiger bis starker Regenschauer;21;21;31
13.08.2020 19:00;613;278;335;Mäßiger bis starker Regenschauer;20;20;15
13.08.2020 20:00;472;222;250;Mäßiger bis starker Regenschauer;19;19;8
13.08.2020 21:00;335;133;202;Mäßiger bis starker Regenschauer;18;18;11
13.08.2020 22:00;254;104;150;Mäßiger bis starker Regenschauer;18;18;5
13.08.2020 23:00;209;83;126;Leicht bewölkt;17;17;0
14.08.2020 00:00;110;49;61;Leicht bewölkt;17;17;0
14.08.2020 01:00;36;14;22;Leicht bewölkt;16;16;0
14.08.2020 02:00;28;13;15;Leicht bewölkt;16;16;0
14.08.2020 03:00;12;5;7;Leicht bewölkt;15;15;0
14.08.2020 04:00;15;10;5;Leicht bewölkt;16;16;0
14.08.2020 05:00;43;24;19;Stellenweiser Regenfall;17;17;1
14.08.2020 06:00;113;69;44;Stellenweiser Regenfall;17;17;2
14.08.2020 07:00;303;173;130;Stellenweiser Regenfall;18;18;1
14.08.2020 08:00;449;276;173;Leichter Regenschauer;19;19;6
14.08.2020 09:00;496;333;163;Leichter Regenschauer;20;20;8
14.08.2020 10:00;494;305;189;Leichter Regenschauer;21;21;4
14.08.2020 11:00;622;354;268;Stellenweiser Regenfall;22;22;3
14.08.2020 12:00;622;284;338;Stellenweiser Regenfall;22;24;4
14.08.2020 13:00;679;331;348;Stellenweiser Regenfall;23;24;2
14.08.2020 14:00;754;368;386;Leicht bewölkt;24;25;1
14.08.2020 15:00;763;348;415;Leicht bewölkt;24;26;1
14.08.2020 16:00;615;268;347;Leicht bewölkt;24;26;1
14.08.2020 17:00;623;290;333;Stellenweiser Regenfall;23;25;0
14.08.2020 18:00;610;272;338;Stellenweiser Regenfall;22;25;0
14.08.2020 19:00;546;251;295;Stellenweiser Regenfall;21;21;0
14.08.2020 20:00;442;221;221;Leicht bewölkt;19;19;0
14.08.2020 21:00;282;132;150;Leicht bewölkt;18;18;0
14.08.2020 22:00;212;92;120;Leicht bewölkt;17;17;0
14.08.2020 23:00;219;101;118;Stellenweiser Regenfall;16;16;4
15.08.2020 00:00;181;67;114;Stellenweiser Regenfall;16;16;5
15.08.2020 01:00;88;30;58;Stellenweiser Regenfall;15;15;3
15.08.2020 02:00;65;20;45;Stellenweiser Regenfall;15;15;1
15.08.2020 03:00;56;10;46;Stellenweiser Regenfall;15;15;2
15.08.2020 04:00;35;20;15;Stellenweiser Regenfall;15;15;1
15.08.2020 05:00;40;17;23;Leicht bewölkt;16;16;0
15.08.2020 06:00;34;21;13;Leicht bewölkt;16;16;0
15.08.2020 07:00;91;50;41;Leicht bewölkt;18;18;0
15.08.2020 08:00;234;120;114;Leicht bewölkt;20;20;0
15.08.2020 09:00;431;275;156;Leicht bewölkt;21;21;0
15.08.2020 10:00;620;344;276;Leicht bewölkt;23;24;0
15.08.2020 11:00;735;425;310;Leicht bewölkt;24;25;0
15.08.2020 12:00;736;368;368;Leicht bewölkt;25;27;0
15.08.2020 13:00;701;320;381;Leicht bewölkt;26;27;0
15.08.2020 14:00;693;324;369;Leicht bewölkt;26;27;0
15.08.2020 15:00;717;352;365;Leicht bewölkt;26;27;0
15.08.2020 16:00;723;342;381;Leicht bewölkt;25;27;0
15.08.2020 17:00;753;349;404;Leicht bewölkt;25;26;0
15.08.2020 18:00;745;378;367;Leicht bewölkt;24;26;0
15.08.2020 19:00;647;353;294;Leicht bewölkt;23;25;0
15.08.2020 20:00;519;230;289;Leicht bewölkt;22;22;0
15.08.2020 21:00;394;183;211;Leicht bewölkt;20;20;0
15.08.2020 22:00;311;120;191;Leicht bewölkt;19;19;0
15.08.2020 23:00;280;108;172;Leicht bewölkt;18;18;0
16.08.2020 00:00;191;75;116;Leicht bewölkt;17;17;0
16.08.2020 01:00;136;46;90;Leicht bewölkt;17;17;0
16.08.2020 02:00;65;18;47;Leicht bewölkt;16;16;0
16.08.2020 03:00;50;15;35;Leicht bewölkt;15;15;0
16.08.2020 04:00;36;11;25;Leicht bewölkt;16;16;0
16.08.2020 05:00;41;12;29;Leicht bewölkt;17;17;0
16.08.2020 06:00;41;22;19;Leicht bewölkt;17;17;0
16.08.2020 07:00;66;38;28;Leicht bewölkt;19;19;0
16.08.2020 08:00;181;114;67;Leicht bewölkt;21;21;0
16.08.2020 09:00;348;179;169;Leicht bewölkt;23;24;0
16.08.2020 10:00;469;238;231;Leicht bewölkt;24;25;0
16.08.2020 11:00;512;221;291;Leicht bewölkt;25;27;0
16.08.2020 12:00;493;249;244;Leicht bewölkt;27;28;0
16.08.2020 13:00;489;233;256;Leicht bewölkt;27;28;0
16.08.2020 14:00;570;273;297;Leicht bewölkt;27;28;0
16.08.2020 15:00;571;317;254;Leicht bewölkt;27;29;0
16.08.2020 16:00;518;236;282;Leicht bewölkt;27;29;0
16.08.2020 17:00;540;271;269;Leicht bewölkt;26;29;0
16.08.2020 18:00;605;279;326;Leicht bewölkt;26;29;0
16.08.2020 19:00;581;275;306;Leicht bewölkt;25;28;0
16.08.2020 20:00;419;180;239;Leicht bewölkt;24;27;0
16.08.2020 21:00;302;129;173;Leicht bewölkt;23;26;0
16.08.2020 22:00;192;71;121;Leicht bewölkt;22;22;0
16.08.2020 23:00;122;53;69;Stellenweiser Regenfall;20;20;0
17.08.2020 00:00;78;32;46;Stellenweiser Regenfall;19;19;0
17.08.2020 01:00;29;10;19;Stellenweiser Regenfall;18;18;0
17.08.2020 02:00;9;4;5;Leicht bewölkt;17;17;9
17.08.2020 03:00;4;0;4;Leicht bewölkt;16;16;12
17.08.2020 04:00;0;0;0;Leicht bewölkt;16;16;6
17.08.2020 05:00;0;0;0;Mäßiger bis starker Regenschauer;17;17;13
17.08.2020 06:00;120;75;45;Mäßiger bis starker Regenschauer;17;17;17
17.08.2020 07:00;284;166;118;Mäßiger bis starker Regenschauer;17;17;9
17.08.2020 08:00;416;232;184;Mäßiger bis starker Regenschauer;17;17;19
17.08.2020 09:00;318;203;115;Mäßiger bis starker Regenschauer;17;17;25
17.08.2020 10:00;235;119;116;Mäßiger bis starker Regenschauer;17;17;12
17.08.2020 11:00;297;161;136;Mäßiger Regenfall;17;17;22
17.08.2020 12:00;388;179;209;Mäßiger Regenfall;16;16;29
17.08.2020 13:00;503;273;230;Mäßiger Regenfall;18;18;15
17.08.2020 14:00;659;367;292;Teilweise mäßiger Regenfall;19;19;7
17.08.2020 15:00;669;334;335;Teilweise mäßiger Regenfall;20;20;1
17.08.2020 16:00;708;319;389;Teilweise mäßiger Regenfall;20;20;5
17.08.2020 17:00;813;354;459;Leicht bewölkt;20;20;0
17.08.2020 18:00;682;314;368;Leicht bewölkt;19;19;0
17.08.2020 19:00;549;248;301;Leicht bewölkt;18;18;0
17.08.2020 20:00;456;206;250;Leicht bewölkt;17;17;0
17.08.2020 21:00;325;117;208;Leicht bewölkt;16;16;0
17.08.2020 22:00;189;73;116;Leicht bewölkt;15;16;0
17.08.2020 23:00;90;36;54;Stellenweiser Regenfall;15;15;7
18.08.2020 00:00;68;25;43;Stellenweiser Regenfall;15;15;1
18.08.2020 01:00;38;8;30;Stellenweiser Regenfall;14;15;5
18.08.2020 02:00;15;10;5;Stellenweiser Regenfall;14;14;2
18.08.2020 03:00;11;6;5;Stellenweiser Regenfall;14;14;3
18.08.2020 04:00;18;12;6;Stellenweiser Regenfall;14;14;2
18.08.2020 05:00;48;35;13;Leicht bewölkt;14;14;0
18.08.2020 06:00;157;101;56;Leicht bewölkt;15;15;0
18.08.2020 07:00;343;203;140;Leicht bewölkt;16;16;0
18.08.2020 08:00;592;348;244;Bewölkt;17;17;3
18.08.2020 09:00;622;373;249;Bewölkt;18;18;4
18.08.2020 10:00;651;367;284;Bewölkt;19;19;2
18.08.2020 11:00;754;419;335;Stellenweiser Regenfall;20;20;7
18.08.2020 12:00;732;323;409;Stellenweiser Regenfall;21;21;9
18.08.2020 13:00;675;327;348;Stellenweiser Regenfall;21;21;5
18.08.2020 14:00;787;394;393;Mäßiger bis starker Regenschauer;22;22;8
18.08.2020 15:00;765;344;421;Mäßiger bis starker Regenschauer;22;24;11
18.08.2020 16:00;889;439;450;Mäßiger bis starker Regenschauer;22;22;5
18.08.2020 17:00;837;407;430;Stellenweiser Regenfall;22;22;11
18.08.2020 18:00;754;320;434;Stellenweiser Regenfall;21;21;15
18.08.2020 19:00;519;233;286;Stellenweiser Regenfall;21;21;7
18.08.2020 20:00;481;205;276;Mäßiger bis starker Regenschauer;20;20;11
18.08.2020 21:00;320;129;191;Mäßiger bis starker Regenschauer;19;19;15
18.08.2020 22:00;238;104;134;Mäßiger bis starker Regenschauer;17;17;7
18.08.2020 23:00;145;61;84;Mäßiger bis starker Regenschauer;15;15;12
19.08.2020 00:00;61;20;41;Mäßiger bis starker Regenschauer;14;14;16
19.08.2020 01:00;56;21;35;Mäßiger bis starker Regenschauer;13;13;8
19.08.2020 02:00;24;10;14;Mäßiger bis starker Regenschauer;13;13;5
19.08.2020 03:00;11;4;7;Mäßiger bis starker Regenschauer;13;13;6
19.08.2020 04:00;22;15;7;Mäßiger bis starker Regenschauer;13;13;3
19.08.2020 05:00;61;38;23;Stellenweiser Regenfall;14;14;1
19.08.2020 06:00;135;88;47;Stellenweiser Regenfall;14;14;1
19.08.2020 07:00;394;233;161;Stellenweiser Regenfall;16;16;1
19.08.2020 08:00;505;302;203;Stellenweiser Regenfall;18;18;0
19.08.2020 09:00;600;342;258;Stellenweiser Regenfall;20;20;0
19.08.2020 10:00;633;365;268;Stellenweiser Regenfall;21;21;0
19.08.2020 11:00;719;408;311;Leicht bewölkt;23;24;0
19.08.2020 12:00;723;353;370;Leicht bewölkt;24;26;0
19.08.2020 13:00;722;364;358;Leicht bewölkt;24;26;0
19.08.2020 14:00;877;471;406;Leicht bewölkt;25;26;0
19.08.2020 15:00;874;427;447;Leicht bewölkt;25;26;0
19.08.2020 16:00;915;427;488;Leicht bewölkt;25;27;0
19.08.2020 17:00;1025;487;538;Leicht bewölkt;25;27;0
19.08.2020 18:00;943;375;568;Leicht bewölkt;24;27;0
19.08.2020 19:00;714;329;385;Leicht bewölkt;24;27;0
19.08.2020 20:00;577;255;322;Leicht bewölkt;23;26;0
19.08.2020 21:00;361;140;221;Leicht bewölkt;22;26;0
19.08.2020 22:00;270;105;165;Leicht bewölkt;20;20;0
19.08.2020 23:00;238;96;142;Leicht bewölkt;18;18;0
20.08.2020 00:00;110;35;75;Leicht bewölkt;17;17;0
20.08.2020 01:00;47;14;33;Leicht bewölkt;17;17;0
20.08.2020 02:00;26;9;17;Leicht bewölkt;17;17;0
20.08.2020 03:00;12;4;8;Leicht bewölkt;17;17;0
20.08.2020 04:00;27;16;11;Leicht bewölkt;18;18;0
20.08.2020 05:00;52;29;23;Leicht bewölkt;18;18;0
20.08.2020 06:00;155;98;57;Leicht bewölkt;19;19;0
20.08.2020 07:00;342;200;142;Leicht bewölkt;21;21;0
20.08.2020 08:00;523;289;234;Leicht bewölkt;23;23;0
20.08.2020 09:00;563;358;205;Leicht bewölkt;25;25;0
20.08.2020 10:00;664;340;324;Leicht bewölkt;26;26;0
20.08.2020 11:00;688;340;348;Leicht bewölkt;27;28;0
20.08.2020 12:00;750;356;394;Leicht bewölkt;29;29;0
20.08.2020 13:00;745;353;392;Leicht bewölkt;29;30;0
20.08.2020 14:00;721;337;384;Leicht bewölkt;30;30;0
20.08.2020 15:00;768;354;414;Leicht bewölkt;30;31;0
20.08.2020 16:00;933;434;499;Leicht bewölkt;30;31;0
20.08.2020 17:00;954;428;526;Leicht bewölkt;29;31;0
20.08.2020 18:00;946;426;520;Leicht bewölkt;29;31;0
20.08.2020 19:00;803;368;435;Leicht bewölkt;28;31;0
20.08.2020 20:00;610;264;346;Leicht bewölkt;28;30;0
20.08.2020 21:00;461;186;275;Leicht bewölkt;27;30;0
20.08.2020 22:00;310;110;200;Leicht bewölkt;25;27;0
20.08.2020 23:00;188;72;116;Leicht bewölkt;22;24;0
21.08.2020 00:00;112;32;80;Leicht bewölkt;20;20;0
21.08.2020 01:00;65;22;43;Leicht bewölkt;19;19;0
21.08.2020 02:00;35;12;23;Leicht bewölkt;18;18;0
21.08.2020 03:00;14;6;8;Leicht bewölkt;18;18;0
21.08.2020 04:00;29;18;11;Leicht bewölkt;18;18;0
21.08.2020 05:00;53;31;22;Leicht bewölkt;19;19;0
21.08.2020 06:00;150;100;50;Leicht bewölkt;20;20;0
21.08.2020 07:00;376;206;170;Leicht bewölkt;21;21;0
21.08.2020 08:00;542;332;210;Leicht bewölkt;23;24;0
21.08.2020 09:00;621;394;227;Leicht bewölkt;25;26;0
21.08.2020 10:00;687;388;299;Leicht bewölkt;27;28;0
21.08.2020 11:00;712;335;377;Leicht bewölkt;29;31;0
21.08.2020 12:00;725;340;385;Leicht bewölkt;31;33;0
21.08.2020 13:00;736;309;427;Leicht bewölkt;31;34;0
21.08.2020 14:00;698;334;364;Leicht bewölkt;31;34;0
21.08.2020 15:00;711;332;379;Leicht bewölkt;32;34;0
21.08.2020 16:00;706;341;365;Leicht bewölkt;31;33;0
21.08.2020 17:00;716;339;377;Leicht bewölkt;30;32;0
21.08.2020 18:00;770;357;413;Leicht bewölkt;29;31;0
21.08.2020 19:00;727;341;386;Leicht bewölkt;28;30;0
21.08.2020 20:00;596;262;334;Leicht bewölkt;27;29;0
21.08.2020 21:00;405;176;229;Leicht bewölkt;25;27;0
21.08.2020 22:00;329;105;224;Leicht bewölkt;24;26;0
21.08.2020 23:00;297;127;170;Leicht bewölkt;22;24;0
22.08.2020 00:00;192;93;99;Leicht bewölkt;21;21;0
22.08.2020 01:00;146;62;84;Leicht bewölkt;20;20;0
22.08.2020 02:00;79;26;53;Leicht bewölkt;19;19;0
22.08.2020 03:00;52;14;38;Leicht bewölkt;18;18;0
22.08.2020 04:00;24;13;11;Leicht bewölkt;18;18;0
22.08.2020 05:00;35;20;15;Leicht bewölkt;19;19;0
22.08.2020 06:00;58;35;23;Leicht bewölkt;19;19;0
22.08.2020 07:00;101;44;57;Leicht bewölkt;19;19;0
22.08.2020 08:00;192;103;89;Leicht bewölkt;20;20;1
22.08.2020 09:00;359;222;137;Leicht bewölkt;21;21;2
22.08.2020 10:00;311;177;134;Leicht bewölkt;22;22;1
22.08.2020 11:00;410;226;184;Leichter Regenschauer;23;23;1
22.08.2020 12:00;425;243;182;Leichter Regenschauer;24;25;1
22.08.2020 13:00;317;164;153;Leichter Regenschauer;24;25;0
22.08.2020 14:00;446;210;236;Leicht bewölkt;25;26;1
22.08.2020 15:00;497;272;225;Leicht bewölkt;26;27;1
22.08.2020 16:00;536;307;229;Leicht bewölkt;25;26;1
22.08.2020 17:00;604;304;300;Stellenweiser Regenfall;24;26;0
22.08.2020 18:00;651;310;341;Stellenweiser Regenfall;24;26;0
22.08.2020 19:00;484;236;248;Stellenweiser Regenfall;23;25;0
22.08.2020 20:00;411;183;228;Leicht bewölkt;21;21;2
22.08.2020 21:00;248;95;153;Leicht bewölkt;20;20;2
22.08.2020 22:00;212;82;130;Leicht bewölkt;19;19;1
22.08.2020 23:00;192;63;129;Bewölkt;18;18;0
23.08.2020 00:00;153;67;86;Bewölkt;17;17;0
23.08.2020 01:00;85;34;51;Bewölkt;16;16;0
23.08.2020 02:00;67;24;43;Leicht bewölkt;16;16;0
23.08.2020 03:00;50;26;24;Leicht bewölkt;16;16;0
23.08.2020 04:00;44;14;30;Leicht bewölkt;16;16;0
23.08.2020 05:00;31;18;13;Bewölkt;16;16;0
23.08.2020 06:00;31;17;14;Bewölkt;16;16;0
23.08.2020 07:00;51;33;18;Bewölkt;17;17;0
23.08.2020 08:00;125;66;59;Leicht bewölkt;18;18;0
23.08.2020 09:00;203;116;87;Leicht bewölkt;19;19;0
23.08.2020 10:00;319;171;148;Leicht bewölkt;20;20;0
23.08.2020 11:00;446;251;195;Leicht bewölkt;21;21;0
23.08.2020 12:00;510;234;276;Leicht bewölkt;22;22;0
23.08.2020 13:00;438;210;228;Leicht bewölkt;22;22;0
23.08.2020 14:00;567;303;264;Leicht bewölkt;22;24;0
23.08.2020 15:00;565;292;273;Leicht bewölkt;22;25;0
23.08.2020 16:00;551;264;287;Leicht bewölkt;21;21;0
23.08.2020 17:00;556;275;281;Leicht bewölkt;20;20;0
23.08.2020 18:00;588;293;295;Leicht bewölkt;20;20;0
23.08.2020 19:00;583;289;294;Leicht bewölkt;18;19;0
23.08.2020 20:00;407;162;245;Leicht bewölkt;17;18;0
23.08.2020 21:00;187;79;108;Leicht bewölkt;16;17;0
23.08.2020 22:00;133;52;81;Leicht bewölkt;16;16;0
23.08.2020 23:00;234;114;120;Leicht bewölkt;15;15;0
24.08.2020 00:00;78;35;43;Leicht bewölkt;14;14;0
24.08.2020 01:00;29;10;19;Leicht bewölkt;13;13;0
24.08.2020 02:00;18;6;12;Bewölkt;13;13;0
24.08.2020 03:00;8;6;2;Bewölkt;12;12;0
24.08.2020 04:00;10;9;1;Bewölkt;12;12;0
24.08.2020 05:00;39;24;15;Leicht bewölkt;12;12;0
24.08.2020 06:00;172;103;69;Leicht bewölkt;13;13;0
24.08.2020 07:00;371;187;184;Leicht bewölkt;14;14;0
24.08.2020 08:00;490;268;222;Leicht bewölkt;16;16;0
24.08.2020 09:00;475;287;188;Leicht bewölkt;18;18;0
24.08.2020 10:00;584;367;217;Leicht bewölkt;19;19;0
24.08.2020 11:00;652;343;309;Leicht bewölkt;20;20;0
24.08.2020 12:00;684;317;367;Leicht bewölkt;21;21;0
24.08.2020 13:00;615;320;295;Leicht bewölkt;21;21;0
24.08.2020 14:00;740;359;381;Leicht bewölkt;21;21;0
24.08.2020 15:00;828;422;406;Leicht bewölkt;21;21;0
24.08.2020 16:00;863;405;458;Leicht bewölkt;20;20;0
24.08.2020 17:00;983;434;549;Stellenweiser Regenfall;19;19;1
24.08.2020 18:00;831;353;478;Stellenweiser Regenfall;18;18;2
24.08.2020 19:00;618;262;356;Stellenweiser Regenfall;17;17;1
24.08.2020 20:00;483;205;278;Stellenweiser Regenfall;16;16;1
24.08.2020 21:00;318;151;167;Stellenweiser Regenfall;15;15;2
24.08.2020 22:00;221;83;138;Stellenweiser Regenfall;14;14;1
24.08.2020 23:00;138;40;98;Leicht bewölkt;13;13;0
25.08.2020 00:00;62;25;37;Leicht bewölkt;13;13;0
25.08.2020 01:00;33;16;17;Leicht bewölkt;12;12;0
25.08.2020 02:00;20;9;11;Leicht bewölkt;11;11;0
25.08.2020 03:00;10;7;3;Leicht bewölkt;10;10;0
25.08.2020 04:00;15;11;4;Leicht bewölkt;10;10;0
25.08.2020 05:00;49;33;16;Leicht bewölkt;11;11;0
25.08.2020 06:00;169;96;73;Leicht bewölkt;12;12;0
25.08.2020 07:00;422;231;191;Leicht bewölkt;14;14;0
25.08.2020 08:00;584;339;245;Leicht bewölkt;16;16;0
25.08.2020 09:00;659;378;281;Leicht bewölkt;18;18;0
25.08.2020 10:00;642;337;305;Leicht bewölkt;20;20;0
25.08.2020 11:00;673;357;316;Leicht bewölkt;21;21;0
25.08.2020 12:00;774;351;423;Leicht bewölkt;23;23;0
25.08.2020 13:00;720;376;344;Leicht bewölkt;23;24;0
25.08.2020 14:00;864;437;427;Leicht bewölkt;24;25;0
25.08.2020 15:00;772;367;405;Leicht bewölkt;24;25;0
25.08.2020 16:00;929;428;501;Leicht bewölkt;23;25;0
25.08.2020 17:00;965;462;503;Leicht bewölkt;23;24;0
25.08.2020 18:00;901;375;526;Leicht bewölkt;22;24;0
25.08.2020 19:00;678;294;384;Leicht bewölkt;21;21;0
25.08.2020 20:00;514;213;301;Sonnig;20;20;0
25.08.2020 21:00;366;156;210;Sonnig;19;19;0
25.08.2020 22:00;185;66;119;Sonnig;18;18;0
25.08.2020 23:00;132;54;78;Leicht bewölkt;17;17;0
26.08.2020 00:00;92;21;71;Leicht bewölkt;16;16;0
26.08.2020 01:00;42;10;32;Leicht bewölkt;15;15;0
26.08.2020 02:00;19;7;12;Leicht bewölkt;15;15;0
26.08.2020 03:00;13;4;9;Leicht bewölkt;14;14;0
26.08.2020 04:00;14;6;8;Leicht bewölkt;15;14;0
26.08.2020 05:00;46;28;18;Leicht bewölkt;15;15;0
26.08.2020 06:00;167;100;67;Leicht bewölkt;16;15;0
26.08.2020 07:00;379;218;161;Leicht bewölkt;17;17;0
26.08.2020 08:00;531;300;231;Leicht bewölkt;18;18;0
26.08.2020 09:00;571;341;230;Leicht bewölkt;19;19;0
26.08.2020 10:00;590;337;253;Leicht bewölkt;20;20;0
26.08.2020 11:00;685;325;360;Leicht bewölkt;21;21;0
26.08.2020 12:00;666;308;358;Leicht bewölkt;22;24;0
26.08.2020 13:00;704;338;366;Leicht bewölkt;23;24;0
26.08.2020 14:00;731;368;363;Leicht bewölkt;23;24;0
26.08.2020 15:00;821;458;363;Leicht bewölkt;23;25;0
26.08.2020 16:00;872;428;444;Leicht bewölkt;22;24;0
26.08.2020 17:00;983;440;543;Leicht bewölkt;21;21;0
26.08.2020 18:00;884;393;491;Leicht bewölkt;21;21;0
26.08.2020 19:00;644;301;343;Leicht bewölkt;20;20;0
26.08.2020 20:00;542;224;318;Leicht bewölkt;19;19;0
26.08.2020 21:00;352;128;224;Leicht bewölkt;18;18;0
26.08.2020 22:00;277;97;180;Leicht bewölkt;17;17;0
26.08.2020 23:00;191;75;116;Leicht bewölkt;15;15;0
27.08.2020 00:00;91;35;56;Leicht bewölkt;14;14;0
27.08.2020 01:00;84;22;62;Leicht bewölkt;13;13;0
27.08.2020 02:00;23;11;12;Leicht bewölkt;12;12;0
27.08.2020 03:00;22;10;12;Leicht bewölkt;11;11;0
27.08.2020 04:00;12;7;5;Leicht bewölkt;11;11;0
27.08.2020 05:00;48;28;20;Leicht bewölkt;12;12;0
27.08.2020 06:00;168;105;63;Leicht bewölkt;13;13;0
27.08.2020 07:00;362;194;168;Leicht bewölkt;14;14;0
27.08.2020 08:00;515;304;211;Leicht bewölkt;16;16;0
27.08.2020 09:00;561;326;235;Leicht bewölkt;18;18;0
27.08.2020 10:00;550;293;257;Leicht bewölkt;19;19;0
27.08.2020 11:00;694;371;323;Leicht bewölkt;20;20;0
27.08.2020 12:00;653;312;341;Leicht bewölkt;21;21;0
27.08.2020 13:00;672;320;352;Leicht bewölkt;21;21;0
27.08.2020 14:00;782;421;361;Leicht bewölkt;22;22;0
27.08.2020 15:00;881;451;430;Leicht bewölkt;22;25;0
27.08.2020 16:00;933;464;469;Leicht bewölkt;22;22;0
27.08.2020 17:00;962;418;544;Leicht bewölkt;21;21;0
27.08.2020 18:00;855;402;453;Leicht bewölkt;21;21;0
27.08.2020 19:00;694;306;388;Leicht bewölkt;20;20;0
27.08.2020 20:00;507;234;273;Leicht bewölkt;18;18;0
27.08.2020 21:00;353;133;220;Leicht bewölkt;17;17;0
27.08.2020 22:00;258;89;169;Leicht bewölkt;16;16;0
27.08.2020 23:00;173;63;110;Leicht bewölkt;14;14;0
28.08.2020 00:00;92;26;66;Leicht bewölkt;13;13;0
28.08.2020 01:00;62;19;43;Leicht bewölkt;13;13;0
28.08.2020 02:00;38;19;19;Leicht bewölkt;13;13;0
28.08.2020 03:00;23;9;14;Leicht bewölkt;13;13;0
28.08.2020 04:00;12;8;4;Leicht bewölkt;13;13;0
28.08.2020 05:00;44;23;21;Leicht bewölkt;14;14;0
28.08.2020 06:00;138;85;53;Leicht bewölkt;14;14;0
28.08.2020 07:00;305;148;157;Leicht bewölkt;16;16;0
28.08.2020 08:00;508;280;228;Leicht bewölkt;18;18;0
28.08.2020 09:00;566;322;244;Leicht bewölkt;19;19;0
28.08.2020 10:00;695;413;282;Leicht bewölkt;21;21;0
28.08.2020 11:00;668;356;312;Leicht bewölkt;22;24;0
28.08.2020 12:00;731;365;366;Leicht bewölkt;23;25;0
28.08.2020 13:00;698;347;351;Leicht bewölkt;22;24;0
28.08.2020 14:00;712;333;379;Leicht bewölkt;21;21;3
28.08.2020 15:00;645;309;336;Leicht bewölkt;20;20;4
28.08.2020 16:00;517;232;285;Leicht bewölkt;19;19;2
28.08.2020 17:00;468;207;261;Leichter Regenfall;17;17;1
28.08.2020 18:00;384;167;217;Leichter Regenfall;16;16;2
28.08.2020 19:00;266;106;160;Leichter Regenfall;15;15;1
28.08.2020 20:00;193;89;104;Bedeckt;15;15;16
28.08.2020 21:00;119;57;62;Bedeckt;14;14;21
28.08.2020 22:00;102;42;60;Bedeckt;14;13;11
28.08.2020 23:00;93;28;65;Mäßiger Regenfall;13;13;15
29.08.2020 00:00;76;27;49;Mäßiger Regenfall;13;12;2
29.08.2020 01:00;93;30;63;Mäßiger Regenfall;13;12;1
29.08.2020 02:00;37;17;20;Teilweise mäßiger Regenfall;12;12;7
29.08.2020 03:00;32;7;25;Teilweise mäßiger Regenfall;12;12;9
29.08.2020 04:00;11;3;8;Teilweise mäßiger Regenfall;12;12;5
29.08.2020 05:00;27;14;13;Stellenweiser leichter Regenfall;12;12;5
29.08.2020 06:00;43;27;16;Stellenweiser leichter Regenfall;12;12;6
29.08.2020 07:00;76;40;36;Stellenweiser leichter Regenfall;13;13;3
29.08.2020 08:00;136;79;57;Leichter Regenfall;13;13;5
29.08.2020 09:00;303;190;113;Leichter Regenfall;13;13;7
29.08.2020 10:00;415;242;173;Leichter Regenfall;13;13;3
29.08.2020 11:00;414;198;216;Stellenweiser leichter Regenfall;13;13;21
29.08.2020 12:00;303;156;147;Stellenweiser leichter Regenfall;14;13;28
29.08.2020 13:00;262;124;138;Stellenweiser leichter Regenfall;14;14;14
29.08.2020 14:00;235;106;129;Starker Regenfall;14;14;22
29.08.2020 15:00;235;95;140;Starker Regenfall;14;14;3
29.08.2020 16:00;208;81;127;Starker Regenfall;14;14;15
29.08.2020 17:00;195;93;102;Mäßiger Regenfall;14;14;32
29.08.2020 18:00;219;109;110;Mäßiger Regenfall;14;14;43
29.08.2020 19:00;161;79;82;Mäßiger Regenfall;13;13;22
29.08.2020 20:00;129;50;79;Starker Regenfall;13;13;18
29.08.2020 21:00;96;58;38;Starker Regenfall;12;12;24
29.08.2020 22:00;82;34;48;Starker Regenfall;12;12;12
29.08.2020 23:00;86;42;44;Mäßiger Regenfall;12;12;12
30.08.2020 00:00;74;26;48;Mäßiger Regenfall;12;12;16
30.08.2020 01:00;52;23;29;Mäßiger Regenfall;12;12;8
30.08.2020 02:00;29;12;17;Mäßiger Regenfall;12;12;13
30.08.2020 03:00;26;10;16;Mäßiger Regenfall;12;12;18
30.08.2020 04:00;10;5;5;Mäßiger Regenfall;12;12;9
30.08.2020 05:00;15;8;7;Mäßiger Regenfall;12;12;17
30.08.2020 06:00;18;13;5;Mäßiger Regenfall;12;12;23
30.08.2020 07:00;15;11;4;Mäßiger Regenfall;12;12;11
30.08.2020 08:00;21;8;13;Mäßiger Regenfall;13;12;16
30.08.2020 09:00;51;25;26;Mäßiger Regenfall;13;12;21
30.08.2020 10:00;56;24;32;Mäßiger Regenfall;13;12;11
30.08.2020 11:00;57;26;31;Mäßiger Regenfall;13;12;25
30.08.2020 12:00;59;30;29;Mäßiger Regenfall;13;12;33
30.08.2020 13:00;69;23;46;Mäßiger Regenfall;13;12;17
30.08.2020 14:00;127;61;66;Starker Regenfall;12;11;31
30.08.2020 15:00;119;61;58;Starker Regenfall;12;11;41
30.08.2020 16:00;106;58;48;Starker Regenfall;12;11;21
30.08.2020 17:00;85;44;41;Starker Regenfall;11;10;21
30.08.2020 18:00;96;53;43;Starker Regenfall;11;10;28
30.08.2020 19:00;120;52;68;Starker Regenfall;11;10;14
30.08.2020 20:00;97;40;57;Mäßiger Regenfall;11;11;7
30.08.2020 21:00;72;35;37;Mäßiger Regenfall;11;11;9
30.08.2020 22:00;48;20;28;Mäßiger Regenfall;11;11;5
30.08.2020 23:00;41;21;20;Stellenweiser Nieselregen;10;10;1
31.08.2020 00:00;26;11;15;Stellenweiser Nieselregen;10;10;1
31.08.2020 01:00;16;11;5;Stellenweiser Nieselregen;10;10;0
31.08.2020 02:00;11;9;2;Leicht bewölkt;10;10;0
31.08.2020 03:00;3;2;1;Leicht bewölkt;10;10;0
31.08.2020 04:00;3;1;2;Leicht bewölkt;10;10;0
31.08.2020 05:00;36;22;14;Bewölkt;10;10;0
31.08.2020 06:00;160;95;65;Bewölkt;10;10;0
31.08.2020 07:00;314;163;151;Bewölkt;11;11;0
31.08.2020 08:00;495;282;213;Leicht bewölkt;12;12;0
31.08.2020 09:00;418;256;162;Leicht bewölkt;13;13;0
31.08.2020 10:00;502;298;204;Leicht bewölkt;14;14;0
31.08.2020 11:00;505;280;225;Leicht bewölkt;15;15;0
31.08.2020 12:00;589;286;303;Leicht bewölkt;16;16;0
31.08.2020 13:00;600;292;308;Leicht bewölkt;17;17;0
31.08.2020 14:00;672;376;296;Leicht bewölkt;17;17;1
31.08.2020 15:00;726;388;338;Leicht bewölkt;18;18;1
31.08.2020 16:00;754;373;381;Leicht bewölkt;17;17;0
31.08.2020 17:00;836;365;471;Stellenweiser Regenfall;17;17;0
31.08.2020 18:00;735;353;382;Stellenweiser Regenfall;17;17;0
31.08.2020 19:00;473;205;268;Stellenweiser Regenfall;16;16;0
31.08.2020 20:00;312;139;173;Leicht bewölkt;15;15;4
31.08.2020 21:00;208;92;116;Leicht bewölkt;15;15;5
31.08.2020 22:00;151;66;85;Leicht bewölkt;14;14;2
31.08.2020 23:00;81;39;42;Leichter Regenschauer;13;13;5
01.09.2020 00:00;36;12;24;Leichter Regenschauer;12;12;7
01.09.2020 01:00;37;13;24;Leichter Regenschauer;11;11;3
01.09.2020 02:00;19;12;7;Leichter Regenschauer;10;11;3
01.09.2020 03:00;9;7;2;Leichter Regenschauer;10;10;4
01.09.2020 04:00;10;5;5;Leichter Regenschauer;10;10;2
01.09.2020 05:00;42;26;16;Leichter Regenschauer;10;10;1
01.09.2020 06:00;156;102;54;Leichter Regenschauer;11;11;1
01.09.2020 07:00;376;198;178;Leichter Regenschauer;12;12;0
01.09.2020 08:00;595;344;251;Leichter Nebel;13;13;0
01.09.2020 09:00;477;281;196;Leichter Nebel;14;14;0
01.09.2020 10:00;521;292;229;Leichter Nebel;15;15;0
01.09.2020 11:00;516;274;242;Stellenweiser Regenfall;16;16;1
01.09.2020 12:00;611;280;331;Stellenweiser Regenfall;17;17;1
01.09.2020 13:00;569;299;270;Stellenweiser Regenfall;17;17;1
01.09.2020 14:00;526;288;238;Stellenweiser Regenfall;17;17;8
01.09.2020 15:00;594;280;314;Stellenweiser Regenfall;17;17;1
01.09.2020 16:00;689;333;356;Stellenweiser Regenfall;16;16;5
01.09.2020 17:00;702;336;366;Mäßiger bis starker Regenschauer;15;15;14
01.09.2020 18:00;625;269;356;Mäßiger bis starker Regenschauer;14;13;19
01.09.2020 19:00;479;212;267;Mäßiger bis starker Regenschauer;13;12;1
01.09.2020 20:00;349;145;204;Mäßiger bis starker Regenschauer;12;11;7
01.09.2020 21:00;234;102;132;Mäßiger bis starker Regenschauer;11;10;1
01.09.2020 22:00;152;64;88;Mäßiger bis starker Regenschauer;11;11;5
01.09.2020 23:00;111;34;77;Leichter Regenschauer;11;11;1
02.09.2020 00:00;67;18;49;Leichter Regenschauer;11;11;1
02.09.2020 01:00;31;15;16;Leichter Regenschauer;10;10;1
02.09.2020 02:00;16;14;2;Leichter Nebel;10;10;0
02.09.2020 03:00;14;6;8;Leichter Nebel;9;9;0
02.09.2020 04:00;16;6;10;Leichter Nebel;10;10;0
02.09.2020 05:00;37;22;15;Leichter Nebel;10;10;0
02.09.2020 06:00;151;94;57;Leichter Nebel;11;11;0
02.09.2020 07:00;351;180;171;Leichter Nebel;12;12;0
02.09.2020 08:00;565;334;231;Stellenweise Gewitter und Niederschläge;13;13;0
02.09.2020 09:00;495;294;201;Stellenweise Gewitter und Niederschläge;14;14;0
02.09.2020 10:00;555;323;232;Stellenweise Gewitter und Niederschläge;15;15;0
02.09.2020 11:00;583;318;265;Leicht bewölkt;17;17;0
02.09.2020 12:00;649;326;323;Leicht bewölkt;18;18;0
02.09.2020 13:00;760;407;353;Leicht bewölkt;18;18;0
02.09.2020 14:00;824;444;380;Leicht bewölkt;19;19;0
02.09.2020 15:00;790;408;382;Leicht bewölkt;19;19;0
02.09.2020 16:00;852;406;446;Leicht bewölkt;18;18;0
02.09.2020 17:00;1063;489;574;Stellenweiser Regenfall;18;18;0
02.09.2020 18:00;885;385;500;Stellenweiser Regenfall;17;17;0
02.09.2020 19:00;612;314;298;Stellenweiser Regenfall;16;16;0
02.09.2020 20:00;446;181;265;Leicht bewölkt;14;14;0
02.09.2020 21:00;311;94;217;Leicht bewölkt;13;13;0
02.09.2020 22:00;239;87;152;Leicht bewölkt;12;12;0
02.09.2020 23:00;169;65;104;Leicht bewölkt;11;11;0
03.09.2020 00:00;53;22;31;Leicht bewölkt;10;10;0
03.09.2020 01:00;52;18;34;Leicht bewölkt;9;9;0
03.09.2020 02:00;25;10;15;Leicht bewölkt;9;9;0
03.09.2020 03:00;9;5;4;Leicht bewölkt;8;8;0
03.09.2020 04:00;13;6;7;Leicht bewölkt;9;9;0
03.09.2020 05:00;51;28;23;Leicht bewölkt;9;9;0
03.09.2020 06:00;148;97;51;Leicht bewölkt;9;9;0
03.09.2020 07:00;401;200;201;Leicht bewölkt;11;11;0
03.09.2020 08:00;590;316;274;Leicht bewölkt;13;13;0
03.09.2020 09:00;553;349;204;Leicht bewölkt;15;15;0
03.09.2020 10:00;612;331;281;Leicht bewölkt;17;17;0
03.09.2020 11:00;643;345;298;Leicht bewölkt;18;18;0
03.09.2020 12:00;716;353;363;Leicht bewölkt;20;20;0
03.09.2020 13:00;766;401;365;Leicht bewölkt;20;20;0
03.09.2020 14:00;831;424;407;Leicht bewölkt;21;21;0
03.09.2020 15:00;867;440;427;Leicht bewölkt;21;21;0
03.09.2020 16:00;922;503;419;Leicht bewölkt;20;20;0
03.09.2020 17:00;1047;507;540;Leicht bewölkt;20;20;0
03.09.2020 18:00;971;441;530;Leicht bewölkt;19;19;0
03.09.2020 19:00;703;368;335;Leicht bewölkt;18;18;0
03.09.2020 20:00;503;182;321;Leicht bewölkt;17;17;0
03.09.2020 21:00;315;128;187;Leicht bewölkt;16;16;0
03.09.2020 22:00;241;76;165;Leicht bewölkt;15;15;0
03.09.2020 23:00;198;57;141;Leicht bewölkt;13;13;0
04.09.2020 00:00;69;21;48;Leicht bewölkt;12;12;0
04.09.2020 01:00;45;13;32;Leicht bewölkt;12;12;0
04.09.2020 02:00;16;5;11;Leicht bewölkt;11;11;0
04.09.2020 03:00;11;3;8;Leicht bewölkt;11;11;0
04.09.2020 04:00;13;10;3;Leicht bewölkt;11;11;0
04.09.2020 05:00;45;28;17;Leicht bewölkt;11;11;0
04.09.2020 06:00;164;106;58;Leicht bewölkt;12;12;0
04.09.2020 07:00;397;220;177;Leicht bewölkt;14;14;0
04.09.2020 08:00;598;340;258;Leicht bewölkt;16;16;0
04.09.2020 09:00;549;343;206;Leicht bewölkt;18;18;0
04.09.2020 10:00;678;403;275;Leicht bewölkt;20;20;0
04.09.2020 11:00;713;389;324;Leicht bewölkt;22;22;0
04.09.2020 12:00;818;347;471;Leicht bewölkt;24;24;0
04.09.2020 13:00;802;391;411;Leicht bewölkt;24;25;0
04.09.2020 14:00;822;414;408;Leicht bewölkt;25;26;0
04.09.2020 15:00;938;485;453;Leicht bewölkt;26;27;0
04.09.2020 16:00;871;400;471;Leicht bewölkt;25;27;0
04.09.2020 17:00;948;459;489;Leicht bewölkt;25;27;0
04.09.2020 18:00;905;419;486;Leicht bewölkt;24;27;0
04.09.2020 19:00;657;322;335;Leicht bewölkt;23;27;0
04.09.2020 20:00;514;233;281;Sonnig;22;26;0
04.09.2020 21:00;335;116;219;Sonnig;21;21;0
04.09.2020 22:00;266;87;179;Sonnig;20;20;0
04.09.2020 23:00;216;80;136;Leicht bewölkt;18;18;0
05.09.2020 00:00;168;55;113;Leicht bewölkt;16;17;0
05.09.2020 01:00;104;46;58;Leicht bewölkt;15;16;0
05.09.2020 02:00;64;24;40;Leicht bewölkt;15;15;0
05.09.2020 03:00;51;8;43;Leicht bewölkt;14;14;0
05.09.2020 04:00;29;14;15;Leicht bewölkt;14;14;0
05.09.2020 05:00;34;19;15;Leicht bewölkt;14;15;0
05.09.2020 06:00;45;30;15;Leicht bewölkt;14;15;0
05.09.2020 07:00;97;46;51;Leicht bewölkt;16;16;0
05.09.2020 08:00;220;122;98;Leicht bewölkt;18;18;0
05.09.2020 09:00;431;239;192;Leicht bewölkt;20;20;0
05.09.2020 10:00;692;414;278;Leicht bewölkt;21;21;0
05.09.2020 11:00;659;349;310;Leicht bewölkt;22;24;0
05.09.2020 12:00;740;376;364;Leicht bewölkt;24;25;0
05.09.2020 13:00;706;341;365;Leicht bewölkt;24;25;0
05.09.2020 14:00;709;333;376;Leicht bewölkt;24;25;0
05.09.2020 15:00;780;384;396;Leicht bewölkt;25;26;0
05.09.2020 16:00;730;367;363;Leicht bewölkt;24;25;0
05.09.2020 17:00;648;297;351;Leicht bewölkt;24;25;0
05.09.2020 18:00;676;308;368;Leicht bewölkt;23;25;0
05.09.2020 19:00;574;291;283;Leicht bewölkt;22;24;0
05.09.2020 20:00;371;161;210;Stellenweiser Regenfall;21;21;1
05.09.2020 21:00;269;113;156;Stellenweiser Regenfall;20;20;1
05.09.2020 22:00;263;86;177;Stellenweiser Regenfall;18;18;0
05.09.2020 23:00;180;61;119;Stellenweiser Regenfall;17;17;1
06.09.2020 00:00;126;37;89;Stellenweiser Regenfall;15;15;2
06.09.2020 01:00;89;26;63;Stellenweiser Regenfall;14;15;1
06.09.2020 02:00;70;22;48;Stellenweiser Regenfall;14;14;0
06.09.2020 03:00;31;15;16;Stellenweiser Regenfall;13;14;0
06.09.2020 04:00;19;4;15;Stellenweiser Regenfall;14;14;0
06.09.2020 05:00;14;5;9;Leichter Nebel;14;15;0
06.09.2020 06:00;34;25;9;Leichter Nebel;14;15;0
06.09.2020 07:00;66;37;29;Leichter Nebel;14;15;0
06.09.2020 08:00;95;54;41;Leichter Nebel;15;15;1
06.09.2020 09:00;225;119;106;Leichter Nebel;15;15;1
06.09.2020 10:00;224;122;102;Leichter Nebel;15;15;0
06.09.2020 11:00;316;175;141;Nieselregen;15;16;2
06.09.2020 12:00;286;147;139;Nieselregen;16;16;2
06.09.2020 13:00;381;217;164;Nieselregen;16;16;1
06.09.2020 14:00;426;218;208;Leichter Regenschauer;15;15;2
06.09.2020 15:00;382;212;170;Leichter Regenschauer;15;15;3
06.09.2020 16:00;369;169;200;Leichter Regenschauer;15;15;1
06.09.2020 17:00;336;166;170;Leichter Regenschauer;14;14;9
06.09.2020 18:00;279;140;139;Leichter Regenschauer;14;14;12
06.09.2020 19:00;164;79;85;Leichter Regenschauer;13;13;6
06.09.2020 20:00;119;48;71;Mäßiger Regenfall;13;13;8
06.09.2020 21:00;82;30;52;Mäßiger Regenfall;12;13;11
06.09.2020 22:00;87;26;61;Mäßiger Regenfall;12;12;6
06.09.2020 23:00;58;24;34;Mäßiger Regenfall;11;11;1
07.09.2020 00:00;32;17;15;Mäßiger Regenfall;11;10;13
07.09.2020 01:00;13;6;7;Mäßiger Regenfall;10;9;6
07.09.2020 02:00;9;4;5;Teilweise mäßiger Regenfall;10;9;3
07.09.2020 03:00;1;0;1;Teilweise mäßiger Regenfall;10;8;4
07.09.2020 04:00;7;3;4;Teilweise mäßiger Regenfall;9;8;2
07.09.2020 05:00;44;24;20;Leichter Nebel;9;8;0
07.09.2020 06:00;180;113;67;Leichter Nebel;9;8;0
07.09.2020 07:00;420;247;173;Leichter Nebel;11;9;0
07.09.2020 08:00;654;378;276;Leicht bewölkt;12;11;0
07.09.2020 09:00;526;296;230;Leicht bewölkt;13;13;0
07.09.2020 10:00;465;260;205;Leicht bewölkt;15;14;0
07.09.2020 11:00;575;321;254;Leicht bewölkt;16;16;0
07.09.2020 12:00;683;376;307;Leicht bewölkt;17;17;0
07.09.2020 13:00;773;424;349;Leicht bewölkt;18;18;0
07.09.2020 14:00;780;395;385;Leicht bewölkt;18;18;0
07.09.2020 15:00;857;423;434;Leicht bewölkt;18;18;0
07.09.2020 16:00;914;407;507;Leicht bewölkt;18;18;0
07.09.2020 17:00;937;403;534;Leicht bewölkt;17;17;0
07.09.2020 18:00;815;363;452;Leicht bewölkt;16;16;0
07.09.2020 19:00;559;221;338;Leicht bewölkt;15;15;0
07.09.2020 20:00;398;170;228;Stellenweiser Regenfall;14;13;0
07.09.2020 21:00;231;97;134;Stellenweiser Regenfall;12;12;0
07.09.2020 22:00;163;61;102;Stellenweiser Regenfall;12;11;0
07.09.2020 23:00;94;31;63;Leicht bewölkt;11;10;0
08.09.2020 00:00;44;11;33;Leicht bewölkt;10;10;0
08.09.2020 01:00;27;8;19;Leicht bewölkt;10;9;0
08.09.2020 02:00;11;7;4;Leicht bewölkt;9;9;0
08.09.2020 03:00;10;3;7;Leicht bewölkt;9;9;0
08.09.2020 04:00;19;7;12;Leicht bewölkt;9;9;0
08.09.2020 05:00;49;29;20;Leichter Nebel;9;9;0
08.09.2020 06:00;214;128;86;Leichter Nebel;10;9;0
08.09.2020 07:00;496;314;182;Leichter Nebel;11;11;0
08.09.2020 08:00;732;418;314;Leicht bewölkt;13;13;0
08.09.2020 09:00;626;356;270;Leicht bewölkt;15;15;0
08.09.2020 10:00;627;370;257;Leicht bewölkt;16;16;0
08.09.2020 11:00;772;402;370;Leicht bewölkt;18;18;0
08.09.2020 12:00;780;359;421;Leicht bewölkt;19;19;0
08.09.2020 13:00;861;419;442;Leicht bewölkt;20;20;0
08.09.2020 14:00;926;545;381;Leicht bewölkt;20;20;0
08.09.2020 15:00;1040;488;552;Leicht bewölkt;21;21;0
08.09.2020 16:00;1088;539;549;Leicht bewölkt;20;20;0
08.09.2020 17:00;1047;465;582;Leicht bewölkt;20;20;0
08.09.2020 18:00;1041;446;595;Leicht bewölkt;19;19;0
08.09.2020 19:00;745;328;417;Leicht bewölkt;18;18;0
08.09.2020 20:00;562;246;316;Leicht bewölkt;17;17;0
08.09.2020 21:00;340;144;196;Leicht bewölkt;15;16;0
08.09.2020 22:00;224;75;149;Leicht bewölkt;14;14;0
08.09.2020 23:00;143;45;98;Leicht bewölkt;13;13;0
09.09.2020 00:00;79;24;55;Leicht bewölkt;12;12;0
09.09.2020 01:00;31;4;27;Leicht bewölkt;12;12;0
09.09.2020 02:00;16;9;7;Leichter Nebel;11;11;0
09.09.2020 03:00;13;6;7;Leichter Nebel;11;11;0
09.09.2020 04:00;10;7;3;Leichter Nebel;11;11;0
09.09.2020 05:00;56;34;22;Leichter Nebel;11;11;0
09.09.2020 06:00;192;109;83;Leichter Nebel;11;11;0
09.09.2020 07:00;465;260;205;Leichter Nebel;13;13;0
09.09.2020 08:00;738;422;316;Bewölkt;15;15;0
09.09.2020 09:00;604;347;257;Bewölkt;17;17;0
09.09.2020 10:00;589;320;269;Bewölkt;18;18;0
09.09.2020 11:00;659;327;332;Leicht bewölkt;20;20;0
09.09.2020 12:00;800;396;404;Leicht bewölkt;22;22;0
09.09.2020 13:00;835;373;462;Leicht bewölkt;23;24;0
09.09.2020 14:00;837;446;391;Leicht bewölkt;23;25;0
09.09.2020 15:00;896;479;417;Leicht bewölkt;24;26;0
09.09.2020 16:00;1029;499;530;Leicht bewölkt;24;25;0
09.09.2020 17:00;1165;540;625;Leicht bewölkt;23;25;0
09.09.2020 18:00;940;401;539;Leicht bewölkt;23;25;0
09.09.2020 19:00;691;318;373;Leicht bewölkt;22;22;0
09.09.2020 20:00;562;214;348;Leicht bewölkt;21;21;0
09.09.2020 21:00;354;134;220;Leicht bewölkt;20;20;0
09.09.2020 22:00;312;141;171;Leicht bewölkt;18;18;0
09.09.2020 23:00;152;61;91;Leicht bewölkt;16;16;0
10.09.2020 00:00;105;46;59;Leicht bewölkt;14;14;0
10.09.2020 01:00;52;12;40;Leicht bewölkt;13;13;0
10.09.2020 02:00;28;6;22;Leicht bewölkt;12;12;0
10.09.2020 03:00;8;5;3;Leicht bewölkt;11;11;0
10.09.2020 04:00;20;12;8;Leicht bewölkt;12;12;0
10.09.2020 05:00;53;32;21;Leicht bewölkt;12;12;0
10.09.2020 06:00;194;113;81;Leicht bewölkt;13;13;0
10.09.2020 07:00;495;286;209;Leicht bewölkt;14;14;0
10.09.2020 08:00;773;417;356;Leicht bewölkt;16;16;0
10.09.2020 09:00;623;374;249;Leicht bewölkt;18;18;0
10.09.2020 10:00;593;302;291;Leicht bewölkt;19;19;0
10.09.2020 11:00;695;357;338;Leicht bewölkt;20;20;0
10.09.2020 12:00;771;367;404;Leicht bewölkt;21;21;0
10.09.2020 13:00;769;385;384;Leicht bewölkt;21;21;0
10.09.2020 14:00;856;438;418;Leicht bewölkt;22;22;0
10.09.2020 15:00;902;406;496;Leicht bewölkt;22;22;0
10.09.2020 16:00;1001;511;490;Leicht bewölkt;21;21;0
10.09.2020 17:00;1094;533;561;Leicht bewölkt;20;20;0
10.09.2020 18:00;953;427;526;Leicht bewölkt;19;19;0
10.09.2020 19:00;769;356;413;Leicht bewölkt;18;18;0
10.09.2020 20:00;554;233;321;Leicht bewölkt;17;16;0
10.09.2020 21:00;401;153;248;Leicht bewölkt;15;15;0
10.09.2020 22:00;280;100;180;Leicht bewölkt;15;15;0
10.09.2020 23:00;170;45;125;Leichter Nebel;15;15;0
11.09.2020 00:00;89;30;59;Leichter Nebel;14;15;0
11.09.2020 01:00;46;13;33;Leichter Nebel;14;14;0
11.09.2020 02:00;23;8;15;Leichter Nebel;14;14;0
11.09.2020 03:00;13;3;10;Leichter Nebel;13;13;0
11.09.2020 04:00;22;12;10;Leichter Nebel;13;14;0
11.09.2020 05:00;42;25;17;Leichter Nebel;14;14;0
11.09.2020 06:00;170;101;69;Leichter Nebel;14;15;0
11.09.2020 07:00;422;247;175;Leichter Nebel;15;16;0
11.09.2020 08:00;719;406;313;Leichter Nebel;17;17;0
11.09.2020 09:00;636;380;256;Leichter Nebel;18;18;0
11.09.2020 10:00;669;379;290;Leichter Nebel;19;19;0
11.09.2020 11:00;772;447;325;Bewölkt;19;20;0
11.09.2020 12:00;843;389;454;Bewölkt;20;20;0
11.09.2020 13:00;800;364;436;Bewölkt;21;21;0
11.09.2020 14:00;968;482;486;Leicht bewölkt;21;21;0
11.09.2020 15:00;945;486;459;Leicht bewölkt;21;21;0
11.09.2020 16:00;880;447;433;Leicht bewölkt;20;20;0
11.09.2020 17:00;920;415;505;Leicht bewölkt;19;19;0
11.09.2020 18:00;882;397;485;Leicht bewölkt;18;18;0
11.09.2020 19:00;669;325;344;Leicht bewölkt;17;17;0
11.09.2020 20:00;528;228;300;Bewölkt;16;16;0
11.09.2020 21:00;274;121;153;Bewölkt;15;15;0
11.09.2020 22:00;273;102;171;Bewölkt;15;15;0
11.09.2020 23:00;201;92;109;Leichter Nebel;14;14;0
12.09.2020 00:00;149;60;89;Leichter Nebel;14;14;0
12.09.2020 01:00;133;54;79;Leichter Nebel;14;14;0
12.09.2020 02:00;58;18;40;Leichter Nebel;13;13;0
12.09.2020 03:00;51;12;39;Leichter Nebel;13;13;0
12.09.2020 04:00;24;7;17;Leichter Nebel;14;14;0
12.09.2020 05:00;31;21;10;Leichter Nebel;14;14;0
12.09.2020 06:00;47;28;19;Leichter Nebel;15;15;0
12.09.2020 07:00;98;51;47;Leichter Nebel;16;16;0
12.09.2020 08:00;231;125;106;Leichter Nebel;17;17;0
12.09.2020 09:00;512;310;202;Leichter Nebel;19;19;0
12.09.2020 10:00;749;407;342;Leichter Nebel;20;20;0
12.09.2020 11:00;840;416;424;Leicht bewölkt;22;22;0
12.09.2020 12:00;683;356;327;Leicht bewölkt;23;24;0
12.09.2020 13:00;785;386;399;Leicht bewölkt;23;24;0
12.09.2020 14:00;929;482;447;Leicht bewölkt;24;25;0
12.09.2020 15:00;795;409;386;Leicht bewölkt;24;26;0
12.09.2020 16:00;727;320;407;Leicht bewölkt;24;25;0
12.09.2020 17:00;770;318;452;Stellenweiser Regenfall;23;25;0
12.09.2020 18:00;741;299;442;Stellenweiser Regenfall;22;25;0
12.09.2020 19:00;652;302;350;Stellenweiser Regenfall;21;21;0
12.09.2020 20:00;423;205;218;Stellenweiser Regenfall;19;19;0
12.09.2020 21:00;335;151;184;Stellenweiser Regenfall;18;18;0
12.09.2020 22:00;232;95;137;Stellenweiser Regenfall;17;17;0
12.09.2020 23:00;211;78;133;Leicht bewölkt;17;17;0
13.09.2020 00:00;164;61;103;Leicht bewölkt;16;16;0
13.09.2020 01:00;137;43;94;Leicht bewölkt;15;15;0
13.09.2020 02:00;68;25;43;Leicht bewölkt;15;15;0
13.09.2020 03:00;57;32;25;Leicht bewölkt;14;15;0
13.09.2020 04:00;34;15;19;Leicht bewölkt;14;15;0
13.09.2020 05:00;27;17;10;Leichter Nebel;14;15;0
13.09.2020 06:00;34;22;12;Leichter Nebel;14;15;0
13.09.2020 07:00;64;33;31;Leichter Nebel;16;16;0
13.09.2020 08:00;134;70;64;Leicht bewölkt;18;18;0
13.09.2020 09:00;312;164;148;Leicht bewölkt;19;19;0
13.09.2020 10:00;385;201;184;Leicht bewölkt;21;21;0
13.09.2020 11:00;499;257;242;Leicht bewölkt;23;25;0
13.09.2020 12:00;509;244;265;Leicht bewölkt;24;26;0
13.09.2020 13:00;596;318;278;Leicht bewölkt;25;26;0
13.09.2020 14:00;633;318;315;Leicht bewölkt;25;26;0
13.09.2020 15:00;644;342;302;Leicht bewölkt;25;26;0
13.09.2020 16:00;608;292;316;Leicht bewölkt;24;26;0
13.09.2020 17:00;627;309;318;Sonnig;23;25;0
13.09.2020 18:00;740;377;363;Sonnig;22;24;0
13.09.2020 19:00;514;238;276;Sonnig;21;21;0
13.09.2020 20:00;328;131;197;Sonnig;20;20;0
13.09.2020 21:00;186;73;113;Sonnig;18;18;0
13.09.2020 22:00;116;52;64;Sonnig;17;17;0
13.09.2020 23:00;64;18;46;Leicht bewölkt;16;16;0
14.09.2020 00:00;41;16;25;Leicht bewölkt;15;15;0
14.09.2020 01:00;20;10;10;Leicht bewölkt;15;15;0
14.09.2020 02:00;6;3;3;Leichter Nebel;14;14;0
14.09.2020 03:00;3;3;0;Leichter Nebel;14;14;0
14.09.2020 04:00;5;5;0;Leichter Nebel;14;14;0
14.09.2020 05:00;55;31;24;Leichter Nebel;14;14;0
14.09.2020 06:00;197;125;72;Leichter Nebel;15;15;0
14.09.2020 07:00;638;341;297;Leichter Nebel;16;16;0
14.09.2020 08:00;906;456;450;Leichter Nebel;18;18;0
14.09.2020 09:00;1032;738;294;Leichter Nebel;19;19;0
14.09.2020 10:00;645;365;280;Leichter Nebel;21;21;0
14.09.2020 11:00;762;423;339;Leicht bewölkt;23;25;0
14.09.2020 12:00;935;520;415;Leicht bewölkt;24;26;0
14.09.2020 13:00;1360;484;876;Leicht bewölkt;25;27;0
14.09.2020 14:00;1121;534;587;Leicht bewölkt;25;27;0
14.09.2020 15:00;1125;497;628;Leicht bewölkt;26;28;0
14.09.2020 16:00;1274;555;719;Leicht bewölkt;25;27;0
14.09.2020 17:00;1239;508;731;Leicht bewölkt;25;27;1
14.09.2020 18:00;1161;487;674;Leicht bewölkt;24;27;1
14.09.2020 19:00;864;377;487;Leicht bewölkt;23;26;1
14.09.2020 20:00;521;207;314;Stellenweiser Regenfall;21;21;0
14.09.2020 21:00;341;154;187;Stellenweiser Regenfall;20;20;0
14.09.2020 22:00;227;84;143;Stellenweiser Regenfall;19;19;0
14.09.2020 23:00;107;47;60;Leicht bewölkt;18;18;0
15.09.2020 00:00;66;17;49;Leicht bewölkt;17;17;0
15.09.2020 01:00;18;3;15;Leicht bewölkt;17;17;0
15.09.2020 02:00;13;3;10;Leicht bewölkt;16;16;0
15.09.2020 03:00;3;2;1;Leicht bewölkt;16;16;0
15.09.2020 04:00;10;6;4;Leicht bewölkt;16;16;0
15.09.2020 05:00;72;41;31;Leicht bewölkt;16;16;0
15.09.2020 06:00;217;133;84;Leicht bewölkt;16;16;0
15.09.2020 07:00;1186;765;421;Leicht bewölkt;17;17;0
15.09.2020 08:00;953;520;433;Leicht bewölkt;19;19;0
15.09.2020 09:00;824;471;353;Leicht bewölkt;21;21;0
15.09.2020 10:00;744;387;357;Leicht bewölkt;22;24;0
15.09.2020 11:00;951;465;486;Leicht bewölkt;24;25;0
15.09.2020 12:00;984;454;530;Leicht bewölkt;26;27;0
15.09.2020 13:00;1314;615;699;Leicht bewölkt;26;27;0
15.09.2020 14:00;1161;514;647;Leicht bewölkt;26;28;0
15.09.2020 15:00;1402;640;762;Leicht bewölkt;27;28;0
15.09.2020 16:00;1371;610;761;Leicht bewölkt;27;28;0
15.09.2020 17:00;1470;610;860;Stellenweiser Regenfall;26;29;1
15.09.2020 18:00;1292;494;798;Stellenweiser Regenfall;26;29;2
15.09.2020 19:00;956;421;535;Stellenweiser Regenfall;25;29;1
15.09.2020 20:00;624;265;359;Stellenweiser Regenfall;24;28;1
15.09.2020 21:00;369;152;217;Stellenweiser Regenfall;24;28;2
15.09.2020 22:00;296;85;211;Stellenweiser Regenfall;22;22;1
15.09.2020 23:00;156;62;94;Leicht bewölkt;19;19;0
16.09.2020 00:00;76;16;60;Leicht bewölkt;17;17;0
16.09.2020 01:00;34;13;21;Leicht bewölkt;16;16;0
16.09.2020 02:00;30;10;20;Leicht bewölkt;16;16;0
16.09.2020 03:00;9;2;7;Leicht bewölkt;15;15;0
16.09.2020 04:00;7;5;2;Leicht bewölkt;15;15;0
16.09.2020 05:00;72;47;25;Leicht bewölkt;15;15;0
16.09.2020 06:00;212;125;87;Leicht bewölkt;15;15;0
16.09.2020 07:00;1207;794;413;Leicht bewölkt;17;17;0
16.09.2020 08:00;923;528;395;Leicht bewölkt;18;18;0
16.09.2020 09:00;857;497;360;Leicht bewölkt;20;20;0
16.09.2020 10:00;812;437;375;Leicht bewölkt;22;22;0
16.09.2020 11:00;908;463;445;Leicht bewölkt;24;25;0
16.09.2020 12:00;1040;510;530;Leicht bewölkt;25;27;0
16.09.2020 13:00;1333;584;749;Leicht bewölkt;25;27;0
16.09.2020 14:00;1102;479;623;Leicht bewölkt;26;27;2
16.09.2020 15:00;1364;537;827;Leicht bewölkt;26;27;2
16.09.2020 16:00;1293;543;750;Leicht bewölkt;25;27;1
16.09.2020 17:00;1478;669;809;Nieselregen mit Gewitter;25;27;1
16.09.2020 18:00;1186;462;724;Nieselregen mit Gewitter;24;27;1
16.09.2020 19:00;882;359;523;Nieselregen mit Gewitter;23;27;1
16.09.2020 20:00;583;214;369;Leicht bewölkt;23;26;1
16.09.2020 21:00;386;152;234;Leicht bewölkt;22;26;1
16.09.2020 22:00;238;94;144;Leicht bewölkt;20;20;1
16.09.2020 23:00;131;51;80;Stellenweiser Regenfall;18;18;0
17.09.2020 00:00;95;31;64;Stellenweiser Regenfall;16;16;0
17.09.2020 01:00;27;13;14;Stellenweiser Regenfall;15;15;0
17.09.2020 02:00;18;5;13;Stellenweiser Regenfall;15;15;0
17.09.2020 03:00;5;2;3;Stellenweiser Regenfall;14;14;0
17.09.2020 04:00;7;2;5;Stellenweiser Regenfall;14;14;0
17.09.2020 05:00;77;54;23;Leicht bewölkt;14;14;0
17.09.2020 06:00;212;125;87;Leicht bewölkt;14;14;0
17.09.2020 07:00;1247;808;439;Leicht bewölkt;15;16;0
17.09.2020 08:00;923;560;363;Leicht bewölkt;17;17;0
17.09.2020 09:00;859;482;377;Leicht bewölkt;18;19;0
17.09.2020 10:00;721;382;339;Leicht bewölkt;20;20;0
17.09.2020 11:00;829;428;401;Leicht bewölkt;21;21;0
17.09.2020 12:00;931;440;491;Leicht bewölkt;23;24;0
17.09.2020 13:00;1405;636;769;Leicht bewölkt;23;24;0
17.09.2020 14:00;1162;520;642;Leicht bewölkt;23;25;0
17.09.2020 15:00;1343;608;735;Leicht bewölkt;24;25;0
17.09.2020 16:00;1381;611;770;Leicht bewölkt;23;24;0
17.09.2020 17:00;1500;645;855;Leicht bewölkt;21;21;0
17.09.2020 18:00;1164;449;715;Leicht bewölkt;20;20;0
17.09.2020 19:00;953;400;553;Leicht bewölkt;20;20;0
17.09.2020 20:00;624;280;344;Leicht bewölkt;19;19;0
17.09.2020 21:00;378;152;226;Leicht bewölkt;18;18;0
17.09.2020 22:00;293;84;209;Leicht bewölkt;17;17;0
17.09.2020 23:00;173;61;112;Leicht bewölkt;16;15;0
18.09.2020 00:00;85;37;48;Leicht bewölkt;15;14;0
18.09.2020 01:00;47;24;23;Leicht bewölkt;14;13;0
18.09.2020 02:00;29;8;21;Leicht bewölkt;13;13;0
18.09.2020 03:00;15;8;7;Leicht bewölkt;13;12;0
18.09.2020 04:00;9;5;4;Leicht bewölkt;13;12;0
18.09.2020 05:00;49;33;16;Leichter Nebel;13;13;0
18.09.2020 06:00;174;102;72;Leichter Nebel;13;13;0
18.09.2020 07:00;1148;777;371;Leichter Nebel;14;14;0
18.09.2020 08:00;862;483;379;Bewölkt;15;15;0
18.09.2020 09:00;804;500;304;Bewölkt;16;16;0
18.09.2020 10:00;819;461;358;Bewölkt;17;17;0
18.09.2020 11:00;937;475;462;Bewölkt;18;18;0
18.09.2020 12:00;1170;558;612;Bewölkt;19;19;0
18.09.2020 13:00;1287;500;787;Bewölkt;20;20;0
18.09.2020 14:00;1150;547;603;Leicht bewölkt;20;20;0
18.09.2020 15:00;1153;521;632;Leicht bewölkt;21;21;0
18.09.2020 16:00;1029;489;540;Leicht bewölkt;20;20;0
18.09.2020 17:00;1173;549;624;Leicht bewölkt;20;20;0
18.09.2020 18:00;1012;463;549;Leicht bewölkt;19;19;0
18.09.2020 19:00;806;366;440;Leicht bewölkt;18;18;0
18.09.2020 20:00;455;190;265;Leicht bewölkt;17;17;0
18.09.2020 21:00;372;153;219;Leicht bewölkt;15;15;0
18.09.2020 22:00;314;88;226;Leicht bewölkt;14;14;0
18.09.2020 23:00;217;81;136;Leichter Nebel;13;12;0
19.09.2020 00:00;164;55;109;Leichter Nebel;11;11;0
19.09.2020 01:00;107;42;65;Leichter Nebel;10;10;0
19.09.2020 02:00;69;14;55;Leicht bewölkt;10;9;0
19.09.2020 03:00;42;10;32;Leicht bewölkt;9;8;0
19.09.2020 04:00;22;10;12;Leicht bewölkt;9;9;0
19.09.2020 05:00;41;21;20;Leicht bewölkt;10;9;0
19.09.2020 06:00;61;43;18;Leicht bewölkt;10;10;0
19.09.2020 07:00;99;47;52;Leicht bewölkt;12;12;0
19.09.2020 08:00;249;127;122;Leicht bewölkt;14;14;0
19.09.2020 09:00;506;295;211;Leicht bewölkt;16;16;0
19.09.2020 10:00;667;365;302;Leicht bewölkt;18;18;0
19.09.2020 11:00;733;408;325;Leicht bewölkt;20;20;0
19.09.2020 12:00;912;538;374;Leicht bewölkt;22;22;0
19.09.2020 13:00;833;404;429;Leicht bewölkt;22;22;0
19.09.2020 14:00;897;417;480;Leicht bewölkt;22;22;0
19.09.2020 15:00;952;460;492;Leicht bewölkt;22;25;0
19.09.2020 16:00;936;417;519;Leicht bewölkt;21;21;0
19.09.2020 17:00;889;377;512;Leicht bewölkt;20;20;0
19.09.2020 18:00;806;362;444;Leicht bewölkt;19;19;0
19.09.2020 19:00;607;253;354;Leicht bewölkt;18;18;0
19.09.2020 20:00;438;208;230;Leicht bewölkt;16;16;0
19.09.2020 21:00;278;126;152;Leicht bewölkt;15;15;0
19.09.2020 22:00;228;98;130;Leicht bewölkt;15;15;0
19.09.2020 23:00;205;83;122;Leicht bewölkt;15;15;0
20.09.2020 00:00;158;70;88;Leicht bewölkt;15;15;0
20.09.2020 01:00;125;39;86;Leicht bewölkt;14;14;0
20.09.2020 02:00;96;41;55;Leichter Nebel;13;13;0
20.09.2020 03:00;68;28;40;Leichter Nebel;12;12;0
20.09.2020 04:00;43;12;31;Leichter Nebel;12;12;0
20.09.2020 05:00;23;6;17;Leichter Nebel;12;12;0
20.09.2020 06:00;40;30;10;Leichter Nebel;13;13;0
20.09.2020 07:00;61;36;25;Leichter Nebel;14;14;0
20.09.2020 08:00;127;62;65;Leichter Nebel;16;16;0
20.09.2020 09:00;307;169;138;Leichter Nebel;18;18;0
20.09.2020 10:00;354;202;152;Leichter Nebel;19;19;0
20.09.2020 11:00;472;245;227;Leicht bewölkt;21;21;0
20.09.2020 12:00;597;308;289;Leicht bewölkt;23;24;0
20.09.2020 13:00;659;327;332;Leicht bewölkt;23;24;0
20.09.2020 14:00;753;352;401;Leicht bewölkt;23;25;1
20.09.2020 15:00;822;379;443;Leicht bewölkt;23;25;1
20.09.2020 16:00;749;365;384;Leicht bewölkt;22;25;0
20.09.2020 17:00;785;377;408;Nieselregen mit Gewitter;22;22;2
20.09.2020 18:00;712;339;373;Nieselregen mit Gewitter;21;21;2
20.09.2020 19:00;490;222;268;Nieselregen mit Gewitter;20;20;1
20.09.2020 20:00;330;127;203;Nieselregen mit Gewitter;19;19;1
20.09.2020 21:00;200;80;120;Nieselregen mit Gewitter;18;18;1
20.09.2020 22:00;170;66;104;Nieselregen mit Gewitter;16;16;1
20.09.2020 23:00;81;38;43;Leicht bewölkt;14;14;0
21.09.2020 00:00;28;13;15;Leicht bewölkt;12;13;0
21.09.2020 01:00;17;10;7;Leicht bewölkt;12;12;0
21.09.2020 02:00;6;3;3;Leichter Nebel;12;12;0
21.09.2020 03:00;6;3;3;Leichter Nebel;11;11;0
21.09.2020 04:00;8;7;1;Leichter Nebel;11;12;0
21.09.2020 05:00;60;36;24;Leicht bewölkt;12;12;0
21.09.2020 06:00;198;128;70;Leicht bewölkt;12;12;0
21.09.2020 07:00;1197;767;430;Leicht bewölkt;14;14;0
21.09.2020 08:00;875;506;369;Leicht bewölkt;15;15;0
21.09.2020 09:00;833;476;357;Leicht bewölkt;17;17;0
21.09.2020 10:00;713;402;311;Leicht bewölkt;19;19;0
21.09.2020 11:00;914;452;462;Leicht bewölkt;21;21;0
21.09.2020 12:00;960;430;530;Leicht bewölkt;22;24;0
21.09.2020 13:00;1292;573;719;Leicht bewölkt;23;24;0
21.09.2020 14:00;1154;547;607;Leicht bewölkt;23;25;0
21.09.2020 15:00;1446;661;785;Leicht bewölkt;23;25;0
21.09.2020 16:00;1343;645;698;Leicht bewölkt;22;22;0
21.09.2020 17:00;1444;614;830;Nieselregen mit Gewitter;21;21;3
21.09.2020 18:00;1118;451;667;Nieselregen mit Gewitter;20;20;4
21.09.2020 19:00;794;327;467;Nieselregen mit Gewitter;19;19;2
21.09.2020 20:00;504;229;275;Stellenweiser Regenfall;17;17;4
21.09.2020 21:00;320;134;186;Stellenweiser Regenfall;16;16;6
21.09.2020 22:00;205;75;130;Stellenweiser Regenfall;15;15;3
21.09.2020 23:00;107;26;81;Leicht bewölkt;15;15;0
22.09.2020 00:00;55;16;39;Leicht bewölkt;15;15;0
22.09.2020 01:00;26;8;18;Leicht bewölkt;14;14;0
22.09.2020 02:00;11;2;9;Stellenweiser Regenfall;13;13;1
22.09.2020 03:00;12;6;6;Stellenweiser Regenfall;12;12;1
22.09.2020 04:00;9;6;3;Stellenweiser Regenfall;12;12;0
22.09.2020 05:00;71;40;31;Stellenweiser Regenfall;12;12;1
22.09.2020 06:00;216;128;88;Stellenweiser Regenfall;12;12;1
22.09.2020 07:00;1217;804;413;Stellenweiser Regenfall;14;14;1
22.09.2020 08:00;940;550;390;Stellenweiser Regenfall;16;16;0
22.09.2020 09:00;808;473;335;Stellenweiser Regenfall;17;17;0
22.09.2020 10:00;730;392;338;Stellenweiser Regenfall;19;19;0
22.09.2020 11:00;860;423;437;Leicht bewölkt;21;21;0
22.09.2020 12:00;955;439;516;Leicht bewölkt;22;23;0
22.09.2020 13:00;1249;533;716;Leicht bewölkt;22;24;0
22.09.2020 14:00;1127;522;605;Stellenweiser Regenfall;23;24;1
22.09.2020 15:00;1263;599;664;Stellenweiser Regenfall;23;25;1
22.09.2020 16:00;1292;622;670;Stellenweiser Regenfall;22;25;1
22.09.2020 17:00;1399;621;778;Stellenweiser Regenfall;21;21;8
22.09.2020 18:00;1147;485;662;Stellenweiser Regenfall;21;21;11
22.09.2020 19:00;824;355;469;Stellenweiser Regenfall;20;20;6
22.09.2020 20:00;549;223;326;Mäßiger bis starker Regenschauer;19;19;8
22.09.2020 21:00;363;132;231;Mäßiger bis starker Regenschauer;18;18;1
22.09.2020 22:00;218;79;139;Mäßiger bis starker Regenschauer;17;17;5
22.09.2020 23:00;120;46;74;Leichter Regenschauer;16;16;5
23.09.2020 00:00;67;27;40;Leichter Regenschauer;15;15;7
23.09.2020 01:00;25;13;12;Leichter Regenschauer;15;15;4
23.09.2020 02:00;24;15;9;Leichter Regenschauer;14;14;3
23.09.2020 03:00;16;10;6;Leichter Regenschauer;14;14;4
23.09.2020 04:00;8;7;1;Leichter Regenschauer;14;14;2
23.09.2020 05:00;58;39;19;Nieselregen;14;14;0
23.09.2020 06:00;211;131;80;Nieselregen;14;14;0
23.09.2020 07:00;1203;768;435;Nieselregen;15;15;0
23.09.2020 08:00;822;486;336;Bedeckt;16;16;1
23.09.2020 09:00;703;430;273;Bedeckt;17;17;1
23.09.2020 10:00;637;363;274;Bedeckt;17;17;1
23.09.2020 11:00;672;336;336;Stellenweiser Regenfall;18;18;1
23.09.2020 12:00;743;357;386;Stellenweiser Regenfall;19;19;13
23.09.2020 13:00;1176;523;653;Stellenweiser Regenfall;19;19;6
23.09.2020 14:00;850;416;434;Mäßiger bis starker Regenschauer;20;20;16
23.09.2020 15:00;1194;483;711;Mäßiger bis starker Regenschauer;20;20;21
23.09.2020 16:00;1208;571;637;Mäßiger bis starker Regenschauer;19;19;11
23.09.2020 17:00;1241;599;642;Mäßiger bis starker Regenschauer;18;18;22
23.09.2020 18:00;1047;464;583;Mäßiger bis starker Regenschauer;17;17;29
23.09.2020 19:00;743;344;399;Mäßiger bis starker Regenschauer;16;16;15
23.09.2020 20:00;474;187;287;Mäßiger bis starker Regenschauer;15;15;9
23.09.2020 21:00;299;130;169;Mäßiger bis starker Regenschauer;14;14;12
23.09.2020 22:00;240;97;143;Mäßiger bis starker Regenschauer;13;13;6
23.09.2020 23:00;158;49;109;Stellenweiser Regenfall;13;13;0
24.09.2020 00:00;73;26;47;Stellenweiser Regenfall;12;12;0
24.09.2020 01:00;29;7;22;Stellenweiser Regenfall;12;12;0
24.09.2020 02:00;18;12;6;Leicht bewölkt;12;12;0
24.09.2020 03:00;9;4;5;Leicht bewölkt;12;12;0
24.09.2020 04:00;14;9;5;Leicht bewölkt;12;12;0
24.09.2020 05:00;54;37;17;Leicht bewölkt;13;13;0
24.09.2020 06:00;156;98;58;Leicht bewölkt;13;13;0
24.09.2020 07:00;953;591;362;Leicht bewölkt;14;14;0
24.09.2020 08:00;788;439;349;Leicht bewölkt;15;15;0
24.09.2020 09:00;694;385;309;Leicht bewölkt;16;16;0
24.09.2020 10:00;577;323;254;Leicht bewölkt;18;18;0
24.09.2020 11:00;643;346;297;Bewölkt;19;19;0
24.09.2020 12:00;743;339;404;Bewölkt;20;20;0
24.09.2020 13:00;950;411;539;Bewölkt;20;20;0
24.09.2020 14:00;957;458;499;Stellenweise Gewitter und Niederschläge;20;20;2
24.09.2020 15:00;1179;563;616;Stellenweise Gewitter und Niederschläge;20;20;2
24.09.2020 16:00;1126;547;579;Stellenweise Gewitter und Niederschläge;18;18;1
24.09.2020 17:00;1073;503;570;Leichter Regenschauer;17;17;9
24.09.2020 18:00;966;399;567;Leichter Regenschauer;16;16;12
24.09.2020 19:00;608;239;369;Leichter Regenschauer;16;16;6
24.09.2020 20:00;343;148;195;Mäßiger bis starker Regenschauer;15;15;14
24.09.2020 21:00;201;75;126;Mäßiger bis starker Regenschauer;15;15;19
24.09.2020 22:00;180;61;119;Mäßiger bis starker Regenschauer;14;14;9
24.09.2020 23:00;84;30;54;Mäßiger Regenfall;14;14;6
25.09.2020 00:00;63;23;40;Mäßiger Regenfall;13;13;8
25.09.2020 01:00;19;5;14;Mäßiger Regenfall;13;13;4
25.09.2020 02:00;9;3;6;Leichter Nebel;12;12;12
25.09.2020 03:00;9;5;4;Leichter Nebel;12;11;16
25.09.2020 04:00;15;9;6;Leichter Nebel;11;10;8
25.09.2020 05:00;54;40;14;Mäßiger Regenfall;10;8;26
25.09.2020 06:00;163;97;66;Mäßiger Regenfall;9;7;35
25.09.2020 07:00;860;563;297;Mäßiger Regenfall;8;6;17
25.09.2020 08:00;606;341;265;Starker Regenfall;8;5;15
25.09.2020 09:00;482;303;179;Starker Regenfall;7;5;2
25.09.2020 10:00;428;243;185;Starker Regenfall;8;5;1
25.09.2020 11:00;646;339;307;Leichter Regenfall;8;6;4
25.09.2020 12:00;600;254;346;Leichter Regenfall;9;6;6
25.09.2020 13:00;913;340;573;Leichter Regenfall;9;7;3
25.09.2020 14:00;654;268;386;Leichter Regenfall;9;7;2
25.09.2020 15:00;530;213;317;Leichter Regenfall;9;7;3
25.09.2020 16:00;535;261;274;Leichter Regenfall;9;7;2
25.09.2020 17:00;616;294;322;Nieselregen;8;6;2
25.09.2020 18:00;579;242;337;Nieselregen;8;6;3
25.09.2020 19:00;441;215;226;Nieselregen;7;5;1
25.09.2020 20:00;301;131;170;Stellenweiser Nieselregen;7;5;2
25.09.2020 21:00;191;85;106;Stellenweiser Nieselregen;7;5;3
25.09.2020 22:00;143;56;87;Stellenweiser Nieselregen;6;4;1
25.09.2020 23:00;130;48;82;Nieselregen;5;3;4
26.09.2020 00:00;102;31;71;Nieselregen;5;2;5
26.09.2020 01:00;92;23;69;Nieselregen;5;2;3
26.09.2020 02:00;46;15;31;Leichter Regenfall;6;2;4
26.09.2020 03:00;38;12;26;Leichter Regenfall;6;2;6
26.09.2020 04:00;17;11;6;Leichter Regenfall;6;2;3
26.09.2020 05:00;28;16;12;Leichter Regenfall;6;2;4
26.09.2020 06:00;46;33;13;Leichter Regenfall;6;1;5
26.09.2020 07:00;75;44;31;Leichter Regenfall;6;1;2
26.09.2020 08:00;186;114;72;Leichter Regenfall;5;1;5
26.09.2020 09:00;277;177;100;Leichter Regenfall;5;0;6
26.09.2020 10:00;419;232;187;Leichter Regenfall;5;0;3
26.09.2020 11:00;399;225;174;Leichter Regenfall;5;0;4
26.09.2020 12:00;393;167;226;Leichter Regenfall;5;0;6
26.09.2020 13:00;396;201;195;Leichter Regenfall;5;0;3
26.09.2020 14:00;416;187;229;Leichter Regenfall;5;0;1
26.09.2020 15:00;383;173;210;Leichter Regenfall;5;0;13
26.09.2020 16:00;326;145;181;Leichter Regenfall;5;1;6
26.09.2020 17:00;349;156;193;Mäßiger Regenfall;4;1;4
26.09.2020 18:00;380;184;196;Mäßiger Regenfall;4;2;6
26.09.2020 19:00;244;113;131;Mäßiger Regenfall;2;1;3
26.09.2020 20:00;244;115;129;Bedeckt;1;1;8
26.09.2020 21:00;142;67;75;Bedeckt;0;0;11
26.09.2020 22:00;115;52;63;Bedeckt;2;1;5
26.09.2020 23:00;110;43;67;Leichter Regenfall;4;1;2
27.09.2020 00:00;103;35;68;Leichter Regenfall;6;2;2
27.09.2020 01:00;62;13;49;Leichter Regenfall;6;2;1
27.09.2020 02:00;49;18;31;Bedeckt;6;2;0
27.09.2020 03:00;43;15;28;Bedeckt;6;2;0
27.09.2020 04:00;29;8;21;Bedeckt;6;2;0
27.09.2020 05:00;14;2;12;Bewölkt;5;2;0
27.09.2020 06:00;39;29;10;Bewölkt;5;2;0
27.09.2020 07:00;42;22;20;Bewölkt;6;3;0
27.09.2020 08:00;92;50;42;Leicht bewölkt;7;4;0
27.09.2020 09:00;200;113;87;Leicht bewölkt;8;6;0
27.09.2020 10:00;300;164;136;Leicht bewölkt;9;7;0
27.09.2020 11:00;363;187;176;Leicht bewölkt;10;8;0
27.09.2020 12:00;396;207;189;Leicht bewölkt;11;9;0
27.09.2020 13:00;443;225;218;Leicht bewölkt;11;9;0
27.09.2020 14:00;519;270;249;Leicht bewölkt;11;9;0
27.09.2020 15:00;487;237;250;Leicht bewölkt;12;9;0
27.09.2020 16:00;578;289;289;Leicht bewölkt;11;9;0
27.09.2020 17:00;565;256;309;Leicht bewölkt;10;8;0
27.09.2020 18:00;455;218;237;Leicht bewölkt;9;7;0
27.09.2020 19:00;264;119;145;Leicht bewölkt;8;6;0
27.09.2020 20:00;208;68;140;Leicht bewölkt;7;5;0
27.09.2020 21:00;160;55;105;Leicht bewölkt;6;5;0
27.09.2020 22:00;89;30;59;Leicht bewölkt;6;4;0
27.09.2020 23:00;59;12;47;Leicht bewölkt;5;4;0
28.09.2020 00:00;35;11;24;Leicht bewölkt;5;4;0
28.09.2020 01:00;15;7;8;Leicht bewölkt;4;4;0
28.09.2020 02:00;4;2;2;Leicht bewölkt;3;3;0
28.09.2020 03:00;4;0;4;Leicht bewölkt;3;2;0
28.09.2020 04:00;9;9;0;Leicht bewölkt;3;2;0
28.09.2020 05:00;45;29;16;Leichter Nebel;3;3;0
28.09.2020 06:00;187;117;70;Leichter Nebel;3;3;0
28.09.2020 07:00;1090;725;365;Leichter Nebel;5;4;0
28.09.2020 08:00;809;465;344;Leicht bewölkt;6;6;0
28.09.2020 09:00;663;355;308;Leicht bewölkt;8;8;0
28.09.2020 10:00;559;294;265;Leicht bewölkt;10;10;0
28.09.2020 11:00;677;346;331;Leicht bewölkt;11;12;0
28.09.2020 12:00;728;346;382;Leicht bewölkt;13;14;0
28.09.2020 13:00;1087;451;636;Leicht bewölkt;13;14;0
28.09.2020 14:00;932;459;473;Leicht bewölkt;13;14;0
28.09.2020 15:00;1196;552;644;Leicht bewölkt;14;14;0
28.09.2020 16:00;1147;512;635;Leicht bewölkt;13;13;0
28.09.2020 17:00;1202;505;697;Stellenweiser Regenfall;12;12;0
28.09.2020 18:00;926;372;554;Stellenweiser Regenfall;11;11;0
28.09.2020 19:00;582;258;324;Stellenweiser Regenfall;10;9;0
28.09.2020 20:00;370;158;212;Leicht bewölkt;8;8;0
28.09.2020 21:00;248;103;145;Leicht bewölkt;7;6;0
28.09.2020 22:00;200;80;120;Leicht bewölkt;7;6;0
28.09.2020 23:00;64;25;39;Leicht bewölkt;6;6;0
29.09.2020 00:00;43;12;31;Leicht bewölkt;6;5;0
29.09.2020 01:00;33;11;22;Leicht bewölkt;7;6;0
29.09.2020 02:00;3;3;0;Nieselregen;7;6;4
29.09.2020 03:00;10;1;9;Nieselregen;7;6;6
29.09.2020 04:00;13;10;3;Nieselregen;7;6;3
29.09.2020 05:00;48;35;13;Leichter Regenfall;7;6;8
29.09.2020 06:00;186;113;73;Leichter Regenfall;7;6;11
29.09.2020 07:00;1077;688;389;Leichter Regenfall;8;6;5
29.09.2020 08:00;837;496;341;Mäßiger Regenfall;8;7;6
29.09.2020 09:00;703;411;292;Mäßiger Regenfall;9;8;8
29.09.2020 10:00;464;273;191;Mäßiger Regenfall;10;8;4
29.09.2020 11:00;565;269;296;Leichter Regenfall;10;9;8
29.09.2020 12:00;621;271;350;Leichter Regenfall;10;9;1
29.09.2020 13:00;894;358;536;Leichter Regenfall;11;10;5
29.09.2020 14:00;732;342;390;Mäßiger Regenfall;11;10;3
29.09.2020 15:00;1000;475;525;Mäßiger Regenfall;11;11;4
29.09.2020 16:00;969;493;476;Mäßiger Regenfall;11;10;2
29.09.2020 17:00;1112;443;669;Nieselregen;11;10;2
29.09.2020 18:00;874;355;519;Nieselregen;10;10;3
29.09.2020 19:00;634;275;359;Nieselregen;9;9;1
29.09.2020 20:00;408;182;226;Leichter Regenfall;7;7;3
29.09.2020 21:00;292;122;170;Leichter Regenfall;6;6;4
29.09.2020 22:00;195;69;126;Leichter Regenfall;6;6;2
29.09.2020 23:00;119;35;84;Leicht bewölkt;7;7;0
30.09.2020 00:00;78;19;59;Leicht bewölkt;7;7;0
30.09.2020 01:00;35;16;19;Leicht bewölkt;7;7;0
30.09.2020 02:00;16;8;8;Leichter Nebel;7;7;0
30.09.2020 03:00;9;2;7;Leichter Nebel;8;8;0
30.09.2020 04:00;10;8;2;Leichter Nebel;8;8;0
30.09.2020 05:00;63;42;21;Leicht bewölkt;8;8;0
30.09.2020 06:00;190;117;73;Leicht bewölkt;8;8;0
30.09.2020 07:00;1103;720;383;Leicht bewölkt;9;9;0
30.09.2020 08:00;910;537;373;Leichter Nebel;10;10;0
30.09.2020 09:00;688;458;230;Leichter Nebel;12;12;0
30.09.2020 10:00;596;337;259;Leichter Nebel;13;13;0
30.09.2020 11:00;753;385;368;Leicht bewölkt;14;14;0
30.09.2020 12:00;883;390;493;Leicht bewölkt;16;16;0
30.09.2020 13:00;1197;534;663;Leicht bewölkt;16;16;0
30.09.2020 14:00;1023;470;553;Leicht bewölkt;17;17;0
30.09.2020 15:00;1306;562;744;Leicht bewölkt;17;17;0
30.09.2020 16:00;1262;588;674;Leicht bewölkt;17;17;0
30.09.2020 17:00;1310;604;706;Leicht bewölkt;17;17;0
30.09.2020 18:00;1105;462;643;Leicht bewölkt;16;16;0
30.09.2020 19:00;730;327;403;Leicht bewölkt;15;15;0
30.09.2020 20:00;517;228;289;Leicht bewölkt;14;14;0
30.09.2020 21:00;319;130;189;Leicht bewölkt;14;14;0
30.09.2020 22:00;245;100;145;Leicht bewölkt;12;12;0
30.09.2020 23:00;152;48;104;Leicht bewölkt;11;11;0
01.10.2020 00:00;75;29;46;Leicht bewölkt;10;10;0
01.10.2020 01:00;29;16;13;Leicht bewölkt;9;9;0
01.10.2020 02:00;15;6;9;Leicht bewölkt;8;8;0
01.10.2020 03:00;6;1;5;Leicht bewölkt;8;8;0
01.10.2020 04:00;4;3;1;Leicht bewölkt;8;8;0
01.10.2020 05:00;61;40;21;Leichter Nebel;8;8;0
01.10.2020 06:00;192;109;83;Leichter Nebel;8;8;0
01.10.2020 07:00;1092;714;378;Leichter Nebel;10;10;0
01.10.2020 08:00;885;520;365;Leicht bewölkt;11;11;0
01.10.2020 09:00;715;405;310;Leicht bewölkt;13;13;0
01.10.2020 10:00;575;307;268;Leicht bewölkt;14;14;0
01.10.2020 11:00;727;355;372;Leicht bewölkt;16;16;0
01.10.2020 12:00;771;358;413;Leicht bewölkt;17;17;0
01.10.2020 13:00;1066;462;604;Leicht bewölkt;18;18;0
01.10.2020 14:00;974;417;557;Leicht bewölkt;18;18;0
01.10.2020 15:00;1137;538;599;Leicht bewölkt;18;18;0
01.10.2020 16:00;1148;565;583;Leicht bewölkt;17;17;0
01.10.2020 17:00;1217;518;699;Leicht bewölkt;17;17;0
01.10.2020 18:00;989;423;566;Leicht bewölkt;16;16;0
01.10.2020 19:00;685;270;415;Leicht bewölkt;14;14;0
01.10.2020 20:00;442;197;245;Leicht bewölkt;13;13;0
01.10.2020 21:00;250;94;156;Leicht bewölkt;12;12;0
01.10.2020 22:00;272;91;181;Leicht bewölkt;11;11;0
01.10.2020 23:00;110;40;70;Stellenweiser leichter Regenfall;11;11;3
02.10.2020 00:00;69;26;43;Stellenweiser leichter Regenfall;11;11;4
02.10.2020 01:00;39;12;27;Stellenweiser leichter Regenfall;11;11;2
02.10.2020 02:00;13;6;7;Leichter Regenfall;10;10;1
02.10.2020 03:00;13;1;12;Leichter Regenfall;10;10;2
02.10.2020 04:00;7;5;2;Leichter Regenfall;10;10;1
02.10.2020 05:00;48;28;20;Stellenweiser Regenfall;10;10;0
02.10.2020 06:00;182;108;74;Stellenweiser Regenfall;10;9;0
02.10.2020 07:00;979;656;323;Stellenweiser Regenfall;10;10;0
02.10.2020 08:00;868;493;375;Stellenweiser Regenfall;11;11;0
02.10.2020 09:00;703;415;288;Stellenweiser Regenfall;12;11;0
02.10.2020 10:00;715;413;302;Stellenweiser Regenfall;13;13;0
02.10.2020 11:00;871;435;436;Leicht bewölkt;15;14;0
02.10.2020 12:00;1000;454;546;Leicht bewölkt;16;16;0
02.10.2020 13:00;1171;484;687;Leicht bewölkt;16;16;0
02.10.2020 14:00;986;481;505;Leicht bewölkt;17;17;0
02.10.2020 15:00;984;487;497;Leicht bewölkt;18;18;0
02.10.2020 16:00;951;452;499;Leicht bewölkt;17;16;0
02.10.2020 17:00;1024;473;551;Leicht bewölkt;16;15;0
02.10.2020 18:00;830;389;441;Leicht bewölkt;15;14;0
02.10.2020 19:00;662;323;339;Leicht bewölkt;14;13;0
02.10.2020 20:00;450;204;246;Leicht bewölkt;13;12;0
02.10.2020 21:00;291;122;169;Leicht bewölkt;12;11;0
02.10.2020 22:00;254;112;142;Leicht bewölkt;12;10;0
02.10.2020 23:00;191;52;139;Leicht bewölkt;11;10;0
03.10.2020 00:00;170;69;101;Leicht bewölkt;11;10;0
03.10.2020 01:00;113;46;67;Leicht bewölkt;10;9;0
03.10.2020 02:00;84;26;58;Leicht bewölkt;10;9;0
03.10.2020 03:00;71;20;51;Leicht bewölkt;9;8;0
03.10.2020 04:00;36;11;25;Leicht bewölkt;9;8;0
03.10.2020 05:00;30;13;17;Leicht bewölkt;9;7;0
03.10.2020 06:00;49;30;19;Leicht bewölkt;8;6;0
03.10.2020 07:00;64;36;28;Leicht bewölkt;8;6;0
03.10.2020 08:00;85;44;41;Stellenweiser Nieselregen;8;5;5
03.10.2020 09:00;111;66;45;Stellenweiser Nieselregen;8;4;7
03.10.2020 10:00;115;69;46;Stellenweiser Nieselregen;8;5;3
03.10.2020 11:00;131;70;61;Leichter Regenfall;8;5;16
03.10.2020 12:00;172;81;91;Leichter Regenfall;8;5;21
03.10.2020 13:00;321;187;134;Leichter Regenfall;9;6;1
03.10.2020 14:00;478;275;203;Teilweise mäßiger Regenfall;9;8;7
03.10.2020 15:00;670;368;302;Teilweise mäßiger Regenfall;10;9;9
03.10.2020 16:00;601;322;279;Teilweise mäßiger Regenfall;10;9;5
03.10.2020 17:00;655;265;390;Stellenweiser Regenfall;10;9;0
03.10.2020 18:00;603;260;343;Stellenweiser Regenfall;9;9;0
03.10.2020 19:00;501;202;299;Stellenweiser Regenfall;8;8;0
03.10.2020 20:00;273;144;129;Leicht bewölkt;7;7;0
03.10.2020 21:00;189;100;89;Leicht bewölkt;6;6;0
03.10.2020 22:00;200;71;129;Leicht bewölkt;6;5;0
03.10.2020 23:00;171;73;98;Leicht bewölkt;5;5;0
04.10.2020 00:00;140;45;95;Leicht bewölkt;5;5;0
04.10.2020 01:00;85;37;48;Leicht bewölkt;5;4;0
04.10.2020 02:00;73;17;56;Leicht bewölkt;4;4;0
04.10.2020 03:00;55;15;40;Leicht bewölkt;4;3;0
04.10.2020 04:00;22;9;13;Leicht bewölkt;5;4;0
04.10.2020 05:00;23;12;11;Leicht bewölkt;5;4;0
04.10.2020 06:00;36;15;21;Leicht bewölkt;5;5;0
04.10.2020 07:00;56;31;25;Leicht bewölkt;7;6;0
04.10.2020 08:00;89;49;40;Leicht bewölkt;8;7;0
04.10.2020 09:00;159;89;70;Leicht bewölkt;9;8;0
04.10.2020 10:00;256;151;105;Leicht bewölkt;11;10;0
04.10.2020 11:00;404;211;193;Bewölkt;12;12;0
04.10.2020 12:00;480;261;219;Bewölkt;14;13;0
04.10.2020 13:00;626;325;301;Bewölkt;14;14;0
04.10.2020 14:00;734;380;354;Leicht bewölkt;15;14;0
04.10.2020 15:00;729;393;336;Leicht bewölkt;15;15;0
04.10.2020 16:00;680;307;373;Leicht bewölkt;14;14;0
04.10.2020 17:00;663;308;355;Leicht bewölkt;13;13;0
04.10.2020 18:00;541;241;300;Leicht bewölkt;12;12;0
04.10.2020 19:00;401;171;230;Leicht bewölkt;11;11;0
04.10.2020 20:00;281;103;178;Leicht bewölkt;10;10;0
04.10.2020 21:00;164;61;103;Leicht bewölkt;8;8;0
04.10.2020 22:00;120;40;80;Leicht bewölkt;9;8;0
04.10.2020 23:00;63;31;32;Leichter Regenfall;9;8;6
05.10.2020 00:00;46;20;26;Leichter Regenfall;9;8;12
05.10.2020 01:00;12;5;7;Leichter Regenfall;9;8;6
05.10.2020 02:00;10;7;3;Leichter Regenfall;9;8;7
05.10.2020 03:00;3;0;3;Leichter Regenfall;9;8;9
05.10.2020 04:00;11;7;4;Leichter Regenfall;8;7;5
05.10.2020 05:00;55;36;19;Stellenweiser leichter Regenfall;8;7;7
05.10.2020 06:00;206;121;85;Stellenweiser leichter Regenfall;8;7;9
05.10.2020 07:00;1026;671;355;Stellenweiser leichter Regenfall;9;7;5
05.10.2020 08:00;829;472;357;Stellenweiser leichter Regenfall;9;8;2
05.10.2020 09:00;682;382;300;Stellenweiser leichter Regenfall;10;8;3
05.10.2020 10:00;553;309;244;Stellenweiser leichter Regenfall;11;9;2
05.10.2020 11:00;641;297;344;Leicht bewölkt;12;10;0
05.10.2020 12:00;733;319;414;Leicht bewölkt;13;11;0
05.10.2020 13:00;1055;465;590;Leicht bewölkt;13;12;0
05.10.2020 14:00;857;364;493;Leichter Regenschauer;13;12;1
05.10.2020 15:00;1101;523;578;Leichter Regenschauer;14;13;1
05.10.2020 16:00;1028;482;546;Leichter Regenschauer;13;12;0
05.10.2020 17:00;1133;475;658;Stellenweiser Regenfall;12;11;0
05.10.2020 18:00;864;344;520;Stellenweiser Regenfall;11;10;0
05.10.2020 19:00;601;260;341;Stellenweiser Regenfall;10;9;0
05.10.2020 20:00;353;160;193;Stellenweiser Regenfall;10;8;0
05.10.2020 21:00;268;112;156;Stellenweiser Regenfall;9;8;0
05.10.2020 22:00;147;71;76;Stellenweiser Regenfall;9;7;0
05.10.2020 23:00;69;21;48;Nieselregen;8;7;0
06.10.2020 00:00;52;15;37;Nieselregen;8;7;0
06.10.2020 01:00;23;10;13;Nieselregen;8;7;0
06.10.2020 02:00;13;4;9;Bedeckt;9;7;0
06.10.2020 03:00;16;10;6;Bedeckt;10;8;0
06.10.2020 04:00;8;4;4;Bedeckt;9;7;0
06.10.2020 05:00;62;47;15;Stellenweiser Regenfall;9;7;0
06.10.2020 06:00;181;108;73;Stellenweiser Regenfall;9;7;0
06.10.2020 07:00;1018;637;381;Stellenweiser Regenfall;9;7;0
06.10.2020 08:00;886;524;362;Bedeckt;10;8;0
06.10.2020 09:00;699;422;277;Bedeckt;11;9;0
06.10.2020 10:00;534;311;223;Bedeckt;12;11;0
06.10.2020 11:00;708;360;348;Leicht bewölkt;14;13;0
06.10.2020 12:00;615;232;383;Leicht bewölkt;15;14;0
06.10.2020 13:00;850;333;517;Leicht bewölkt;14;14;0
06.10.2020 14:00;713;329;384;Bewölkt;14;13;2
06.10.2020 15:00;905;462;443;Bewölkt;13;12;3
06.10.2020 16:00;949;435;514;Bewölkt;12;11;1
06.10.2020 17:00;1077;500;577;Leichter Regenfall;11;10;1
06.10.2020 18:00;888;398;490;Leichter Regenfall;10;9;1
06.10.2020 19:00;571;236;335;Leichter Regenfall;10;9;1
06.10.2020 20:00;355;169;186;Leicht bewölkt;10;9;3
06.10.2020 21:00;247;117;130;Leicht bewölkt;10;8;4
06.10.2020 22:00;165;66;99;Leicht bewölkt;9;7;2
06.10.2020 23:00;92;37;55;Mäßiger bis starker Regen mit Gewitter;8;6;14
07.10.2020 00:00;64;22;42;Mäßiger bis starker Regen mit Gewitter;6;5;19
07.10.2020 01:00;27;4;23;Mäßiger bis starker Regen mit Gewitter;7;5;1
07.10.2020 02:00;12;3;9;Mäßiger Regenfall;7;6;7
07.10.2020 03:00;8;5;3;Mäßiger Regenfall;8;6;9
07.10.2020 04:00;8;2;6;Mäßiger Regenfall;8;6;4
07.10.2020 05:00;51;31;20;Leichter Regenfall;8;6;5
07.10.2020 06:00;160;97;63;Leichter Regenfall;8;6;7
07.10.2020 07:00;1003;632;371;Leichter Regenfall;9;6;3
07.10.2020 08:00;803;470;333;Leichter Regenfall;9;6;6
07.10.2020 09:00;636;405;231;Leichter Regenfall;9;6;8
07.10.2020 10:00;502;254;248;Leichter Regenfall;9;6;4
07.10.2020 11:00;576;285;291;Leichter Regenfall;9;7;5
07.10.2020 12:00;758;342;416;Leichter Regenfall;10;7;7
07.10.2020 13:00;947;422;525;Leichter Regenfall;10;7;3
07.10.2020 14:00;736;355;381;Leichter Regenfall;10;8;4
07.10.2020 15:00;939;409;530;Leichter Regenfall;11;8;5
07.10.2020 16:00;918;443;475;Leichter Regenfall;10;8;3
07.10.2020 17:00;1026;470;556;Leichter Regenschauer;10;8;3
07.10.2020 18:00;926;406;520;Leichter Regenschauer;10;8;4
07.10.2020 19:00;694;321;373;Leichter Regenschauer;9;8;2
07.10.2020 20:00;423;195;228;Leichter Regenschauer;9;7;3
07.10.2020 21:00;323;130;193;Leichter Regenschauer;8;7;4
07.10.2020 22:00;254;91;163;Leichter Regenschauer;8;6;2
07.10.2020 23:00;153;54;99;Stellenweiser Regenfall;7;6;1
08.10.2020 00:00;70;19;51;Stellenweiser Regenfall;7;6;1
08.10.2020 01:00;40;13;27;Stellenweiser Regenfall;7;5;1
08.10.2020 02:00;26;10;16;Leichter Regenschauer;6;5;0
08.10.2020 03:00;14;1;13;Leichter Regenschauer;6;5;0
08.10.2020 04:00;9;7;2;Leichter Regenschauer;6;5;0
08.10.2020 05:00;60;41;19;Leicht bewölkt;6;5;0
08.10.2020 06:00;187;113;74;Leicht bewölkt;5;5;0
08.10.2020 07:00;1067;685;382;Leicht bewölkt;7;6;0
08.10.2020 08:00;899;508;391;Leicht bewölkt;8;7;0
08.10.2020 09:00;670;413;257;Leicht bewölkt;9;8;0
08.10.2020 10:00;502;266;236;Leicht bewölkt;10;10;0
08.10.2020 11:00;721;350;371;Bewölkt;11;11;0
08.10.2020 12:00;857;418;439;Bewölkt;12;12;0
08.10.2020 13:00;1095;471;624;Bewölkt;13;13;0
08.10.2020 14:00;1040;536;504;Leicht bewölkt;14;14;0
08.10.2020 15:00;1224;580;644;Leicht bewölkt;14;15;0
08.10.2020 16:00;1232;589;643;Leicht bewölkt;14;14;0
08.10.2020 17:00;1317;577;740;Leicht bewölkt;14;14;0
08.10.2020 18:00;1121;494;627;Leicht bewölkt;13;13;0
08.10.2020 19:00;818;364;454;Leicht bewölkt;12;12;0
08.10.2020 20:00;429;199;230;Leicht bewölkt;11;10;0
08.10.2020 21:00;354;127;227;Leicht bewölkt;9;9;0
08.10.2020 22:00;281;102;179;Leicht bewölkt;9;9;0
08.10.2020 23:00;159;55;104;Bewölkt;8;8;0
09.10.2020 00:00;82;33;49;Bewölkt;8;8;0
09.10.2020 01:00;57;15;42;Bewölkt;8;8;0
09.10.2020 02:00;12;5;7;Leicht bewölkt;8;7;0
09.10.2020 03:00;12;8;4;Leicht bewölkt;8;7;0
09.10.2020 04:00;16;10;6;Leicht bewölkt;8;7;0
09.10.2020 05:00;55;35;20;Leicht bewölkt;8;7;0
09.10.2020 06:00;167;104;63;Leicht bewölkt;8;7;0
09.10.2020 07:00;951;624;327;Leicht bewölkt;9;9;0
09.10.2020 08:00;863;474;389;Leicht bewölkt;11;11;0
09.10.2020 09:00;760;481;279;Leicht bewölkt;12;12;0
09.10.2020 10:00;711;410;301;Leicht bewölkt;14;14;0
09.10.2020 11:00;883;411;472;Leicht bewölkt;15;15;0
09.10.2020 12:00;1059;460;599;Leicht bewölkt;17;17;0
09.10.2020 13:00;1245;554;691;Leicht bewölkt;17;17;0
09.10.2020 14:00;1072;503;569;Leicht bewölkt;17;17;0
09.10.2020 15:00;1135;561;574;Leicht bewölkt;17;17;0
09.10.2020 16:00;1095;498;597;Leicht bewölkt;16;16;0
09.10.2020 17:00;1090;488;602;Leicht bewölkt;16;16;0
09.10.2020 18:00;907;399;508;Leicht bewölkt;15;15;0
09.10.2020 19:00;722;341;381;Leicht bewölkt;14;14;0
09.10.2020 20:00;458;181;277;Bedeckt;13;13;0
09.10.2020 21:00;321;135;186;Bedeckt;12;12;0
09.10.2020 22:00;260;121;139;Bedeckt;12;12;0
09.10.2020 23:00;237;86;151;Leicht bewölkt;11;11;0
10.10.2020 00:00;177;66;111;Leicht bewölkt;10;10;0
10.10.2020 01:00;115;32;83;Leicht bewölkt;10;10;0
10.10.2020 02:00;65;15;50;Leicht bewölkt;10;9;0
10.10.2020 03:00;41;13;28;Leicht bewölkt;10;9;0
10.10.2020 04:00;30;12;18;Leicht bewölkt;10;9;0
10.10.2020 05:00;30;15;15;Leicht bewölkt;10;9;0
10.10.2020 06:00;50;28;22;Leicht bewölkt;10;9;0
10.10.2020 07:00;58;32;26;Leicht bewölkt;10;9;0
10.10.2020 08:00;134;83;51;Bewölkt;10;9;9
10.10.2020 09:00;204;135;69;Bewölkt;10;9;12
10.10.2020 10:00;210;123;87;Bewölkt;10;9;6
10.10.2020 11:00;232;132;100;Mäßiger Regenfall;10;8;18
10.10.2020 12:00;296;143;153;Mäßiger Regenfall;10;8;24
10.10.2020 13:00;241;115;126;Mäßiger Regenfall;10;9;12
10.10.2020 14:00;241;117;124;Mäßiger Regenfall;10;9;9
10.10.2020 15:00;312;156;156;Mäßiger Regenfall;10;9;12
10.10.2020 16:00;370;182;188;Mäßiger Regenfall;9;9;6
10.10.2020 17:00;395;184;211;Leichter Regenfall;9;8;4
10.10.2020 18:00;400;176;224;Leichter Regenfall;8;8;5
10.10.2020 19:00;321;153;168;Leichter Regenfall;7;7;3
10.10.2020 20:00;238;108;130;Leichter Regenfall;7;6;3
10.10.2020 21:00;143;59;84;Leichter Regenfall;6;5;4
10.10.2020 22:00;99;52;47;Leichter Regenfall;6;5;2
10.10.2020 23:00;134;49;85;Stellenweiser Regenfall;6;5;2
11.10.2020 00:00;114;52;62;Stellenweiser Regenfall;6;5;3
11.10.2020 01:00;91;26;65;Stellenweiser Regenfall;5;5;1
11.10.2020 02:00;65;25;40;Leichter Regenschauer;5;4;1
11.10.2020 03:00;41;10;31;Leichter Regenschauer;5;4;2
11.10.2020 04:00;28;10;18;Leichter Regenschauer;4;3;1
11.10.2020 05:00;21;8;13;Leichter Regenschauer;4;3;1
11.10.2020 06:00;24;17;7;Leichter Regenschauer;3;3;1
11.10.2020 07:00;41;23;18;Leichter Regenschauer;4;4;1
11.10.2020 08:00;99;57;42;Stellenweiser Regenfall;6;5;0
11.10.2020 09:00;203;105;98;Stellenweiser Regenfall;7;6;0
11.10.2020 10:00;299;145;154;Stellenweiser Regenfall;8;8;0
11.10.2020 11:00;381;210;171;Leicht bewölkt;9;9;0
11.10.2020 12:00;377;196;181;Leicht bewölkt;11;11;0
11.10.2020 13:00;479;258;221;Leicht bewölkt;11;11;0
11.10.2020 14:00;617;287;330;Leicht bewölkt;11;11;1
11.10.2020 15:00;542;252;290;Leicht bewölkt;10;10;2
11.10.2020 16:00;543;233;310;Leicht bewölkt;9;9;1
11.10.2020 17:00;546;241;305;Leichter Regenschauer;8;8;4
11.10.2020 18:00;365;159;206;Leichter Regenschauer;7;6;5
11.10.2020 19:00;234;116;118;Leichter Regenschauer;6;5;2
11.10.2020 20:00;167;76;91;Leichter Regenschauer;5;4;4
11.10.2020 21:00;118;40;78;Leichter Regenschauer;5;3;6
11.10.2020 22:00;113;45;68;Leichter Regenschauer;4;3;3
11.10.2020 23:00;67;30;37;Stellenweiser Regenfall;3;2;3
12.10.2020 00:00;31;17;14;Stellenweiser Regenfall;3;2;4
12.10.2020 01:00;5;4;1;Stellenweiser Regenfall;3;2;2
12.10.2020 02:00;7;4;3;Leichter Regenfall;2;1;1
12.10.2020 03:00;1;1;0;Leichter Regenfall;2;1;2
12.10.2020 04:00;5;2;3;Leichter Regenfall;2;1;1
12.10.2020 05:00;45;28;17;Leichter Regenschauer;2;1;1
12.10.2020 06:00;164;101;63;Leichter Regenschauer;2;2;1
12.10.2020 07:00;1009;677;332;Leichter Regenschauer;3;2;1
12.10.2020 08:00;798;445;353;Leichter Regenschauer;4;3;1
12.10.2020 09:00;614;356;258;Leichter Regenschauer;5;4;1
12.10.2020 10:00;492;260;232;Leichter Regenschauer;6;5;0
12.10.2020 11:00;556;242;314;Stellenweiser Regenfall;6;5;1
12.10.2020 12:00;643;276;367;Stellenweiser Regenfall;7;6;2
12.10.2020 13:00;882;406;476;Stellenweiser Regenfall;7;6;1
12.10.2020 14:00;718;336;382;Nieselregen;7;6;2
12.10.2020 15:00;978;465;513;Nieselregen;7;6;2
12.10.2020 16:00;899;416;483;Nieselregen;7;6;1
12.10.2020 17:00;995;392;603;Leichter Regenschauer;6;5;2
12.10.2020 18:00;827;406;421;Leichter Regenschauer;5;5;3
12.10.2020 19:00;580;249;331;Leichter Regenschauer;5;4;1
12.10.2020 20:00;387;166;221;Nieselregen;4;4;1
12.10.2020 21:00;265;109;156;Nieselregen;4;3;2
12.10.2020 22:00;182;81;101;Nieselregen;3;3;1
12.10.2020 23:00;116;41;75;Leicht bewölkt;2;2;0
13.10.2020 00:00;60;22;38;Leicht bewölkt;2;2;0
13.10.2020 01:00;36;10;26;Leicht bewölkt;1;1;0
13.10.2020 02:00;16;7;9;Leicht bewölkt;1;1;0
13.10.2020 03:00;2;0;2;Leicht bewölkt;1;1;0
13.10.2020 04:00;13;11;2;Leicht bewölkt;1;1;0
13.10.2020 05:00;48;33;15;Leicht bewölkt;0;0;0
13.10.2020 06:00;189;105;84;Leicht bewölkt;0;0;0
13.10.2020 07:00;1020;643;377;Leicht bewölkt;2;2;0
13.10.2020 08:00;888;516;372;Leicht bewölkt;4;4;0
13.10.2020 09:00;655;372;283;Leicht bewölkt;5;5;0
13.10.2020 10:00;556;316;240;Leicht bewölkt;7;7;0
13.10.2020 11:00;704;351;353;Leicht bewölkt;9;9;0
13.10.2020 12:00;786;352;434;Leicht bewölkt;10;10;0
13.10.2020 13:00;1084;477;607;Leicht bewölkt;10;10;0
13.10.2020 14:00;920;407;513;Leicht bewölkt;10;10;0
13.10.2020 15:00;1155;569;586;Leicht bewölkt;10;10;0
13.10.2020 16:00;1166;574;592;Leicht bewölkt;10;10;0
13.10.2020 17:00;1212;543;669;Leicht bewölkt;9;9;0
13.10.2020 18:00;1114;471;643;Leicht bewölkt;9;9;0
13.10.2020 19:00;685;285;400;Leicht bewölkt;7;7;0
13.10.2020 20:00;458;203;255;Leicht bewölkt;6;6;0
13.10.2020 21:00;282;128;154;Leicht bewölkt;5;5;0
13.10.2020 22:00;237;82;155;Leicht bewölkt;4;4;0
13.10.2020 23:00;130;51;79;Leicht bewölkt;3;3;0
14.10.2020 00:00;62;18;44;Leicht bewölkt;2;2;0
14.10.2020 01:00;48;10;38;Leicht bewölkt;2;1;0
14.10.2020 02:00;29;13;16;Leicht bewölkt;1;1;0
14.10.2020 03:00;11;2;9;Leicht bewölkt;1;0;0
14.10.2020 04:00;15;11;4;Leicht bewölkt;1;-1;0
14.10.2020 05:00;53;33;20;Leicht bewölkt;0;-1;0
14.10.2020 06:00;179;97;82;Leicht bewölkt;0;-1;0
14.10.2020 07:00;1031;647;384;Leicht bewölkt;2;0;0
14.10.2020 08:00;838;483;355;Leichter Nebel;3;2;0
14.10.2020 09:00;640;413;227;Leichter Nebel;5;3;0
14.10.2020 10:00;563;310;253;Leichter Nebel;6;5;0
14.10.2020 11:00;759;361;398;Leicht bewölkt;8;6;0
14.10.2020 12:00;874;387;487;Leicht bewölkt;9;8;0
14.10.2020 13:00;1181;563;618;Leicht bewölkt;9;8;0
14.10.2020 14:00;949;470;479;Leicht bewölkt;10;8;0
14.10.2020 15:00;1133;516;617;Leicht bewölkt;10;8;0
14.10.2020 16:00;1167;539;628;Leicht bewölkt;9;6;0
14.10.2020 17:00;1184;509;675;Leicht bewölkt;8;5;0
14.10.2020 18:00;989;397;592;Leicht bewölkt;7;4;0
14.10.2020 19:00;646;281;365;Leicht bewölkt;6;3;0
14.10.2020 20:00;481;201;280;Leicht bewölkt;5;2;0
14.10.2020 21:00;268;129;139;Leicht bewölkt;4;2;0
14.10.2020 22:00;230;86;144;Leicht bewölkt;4;1;0
14.10.2020 23:00;180;55;125;Leicht bewölkt;4;1;0
15.10.2020 00:00;81;23;58;Leicht bewölkt;4;1;0
15.10.2020 01:00;47;14;33;Leicht bewölkt;4;1;0
15.10.2020 02:00;19;7;12;Leichter Nebel;4;1;0
15.10.2020 03:00;9;4;5;Leichter Nebel;4;1;0
15.10.2020 04:00;13;8;5;Leichter Nebel;4;2;0
15.10.2020 05:00;48;32;16;Leichter Nebel;4;2;0
15.10.2020 06:00;184;118;66;Leichter Nebel;4;2;0
15.10.2020 07:00;1090;684;406;Leichter Nebel;5;3;0
15.10.2020 08:00;878;510;368;Leichter Nebel;5;4;0
15.10.2020 09:00;713;416;297;Leichter Nebel;6;4;0
15.10.2020 10:00;531;283;248;Leichter Nebel;7;5;0
15.10.2020 11:00;627;328;299;Bedeckt;8;6;0
15.10.2020 12:00;718;314;404;Bedeckt;8;6;0
15.10.2020 13:00;956;391;565;Bedeckt;8;6;0
15.10.2020 14:00;800;355;445;Stellenweiser Regenfall;8;6;0
15.10.2020 15:00;1027;525;502;Stellenweiser Regenfall;8;6;0
15.10.2020 16:00;980;487;493;Stellenweiser Regenfall;8;6;0
15.10.2020 17:00;1012;443;569;Stellenweiser Regenfall;8;6;0
15.10.2020 18:00;893;354;539;Stellenweiser Regenfall;8;6;0
15.10.2020 19:00;617;276;341;Stellenweiser Regenfall;8;6;0
15.10.2020 20:00;407;186;221;Leichter Nebel;8;6;2
15.10.2020 21:00;269;101;168;Leichter Nebel;8;6;2
15.10.2020 22:00;250;97;153;Leichter Nebel;7;6;1
15.10.2020 23:00;133;49;84;Nieselregen;7;6;7
16.10.2020 00:00;87;26;61;Nieselregen;7;7;9
16.10.2020 01:00;57;15;42;Nieselregen;7;7;4
16.10.2020 02:00;22;13;9;Mäßiger Regenfall;7;7;8
16.10.2020 03:00;24;6;18;Mäßiger Regenfall;7;7;11
16.10.2020 04:00;13;6;7;Mäßiger Regenfall;7;7;5
16.10.2020 05:00;47;29;18;Leichter Regenfall;7;7;6
16.10.2020 06:00;150;92;58;Leichter Regenfall;7;7;8
16.10.2020 07:00;863;541;322;Leichter Regenfall;7;7;4
16.10.2020 08:00;738;408;330;Leichter Regenfall;8;7;4
16.10.2020 09:00;539;327;212;Leichter Regenfall;8;7;5
16.10.2020 10:00;381;211;170;Leichter Regenfall;8;8;2
16.10.2020 11:00;483;223;260;Leichter Regenfall;9;8;4
16.10.2020 12:00;635;266;369;Leichter Regenfall;9;9;5
16.10.2020 13:00;774;328;446;Leichter Regenfall;9;9;3
16.10.2020 14:00;625;285;340;Leichter Regenfall;9;9;4
16.10.2020 15:00;640;293;347;Leichter Regenfall;9;9;5
16.10.2020 16:00;520;256;264;Leichter Regenfall;9;8;2
16.10.2020 17:00;501;196;305;Leichter Regenschauer;8;8;6
16.10.2020 18:00;445;192;253;Leichter Regenschauer;8;7;8
16.10.2020 19:00;411;215;196;Leichter Regenschauer;6;5;4
16.10.2020 20:00;254;124;130;Leichter Regenfall;5;4;4
16.10.2020 21:00;204;96;108;Leichter Regenfall;3;3;6
16.10.2020 22:00;171;75;96;Leichter Regenfall;4;3;3
16.10.2020 23:00;143;60;83;Leichter Regenschauer;5;4;2
17.10.2020 00:00;120;51;69;Leichter Regenschauer;6;4;3
17.10.2020 01:00;76;28;48;Leichter Regenschauer;6;4;1
17.10.2020 02:00;67;26;41;Leichter Regenschauer;5;3;1
17.10.2020 03:00;55;9;46;Leichter Regenschauer;5;3;1
17.10.2020 04:00;18;8;10;Leichter Regenschauer;5;3;1
17.10.2020 05:00;38;20;18;Leichter Nebel;4;3;0
17.10.2020 06:00;56;37;19;Leichter Nebel;4;2;0
17.10.2020 07:00;82;45;37;Leichter Nebel;5;3;0
17.10.2020 08:00;168;99;69;Leichter Nebel;6;4;0
17.10.2020 09:00;378;236;142;Leichter Nebel;6;5;0
17.10.2020 10:00;514;322;192;Leichter Nebel;7;6;0
17.10.2020 11:00;613;335;278;Stellenweiser Regenfall;8;7;1
17.10.2020 12:00;779;358;421;Stellenweiser Regenfall;9;8;1
17.10.2020 13:00;684;320;364;Stellenweiser Regenfall;9;8;0
17.10.2020 14:00;727;340;387;Stellenweiser Regenfall;9;9;1
17.10.2020 15:00;688;322;366;Stellenweiser Regenfall;10;10;1
17.10.2020 16:00;619;283;336;Stellenweiser Regenfall;9;9;0
17.10.2020 17:00;655;272;383;Stellenweiser Regenfall;8;8;1
17.10.2020 18:00;552;234;318;Stellenweiser Regenfall;7;7;1
17.10.2020 19:00;449;229;220;Stellenweiser Regenfall;7;7;1
17.10.2020 20:00;323;141;182;Leichter Regenschauer;6;6;1
17.10.2020 21:00;206;96;110;Leichter Regenschauer;5;5;1
17.10.2020 22:00;158;68;90;Leichter Regenschauer;5;5;0
17.10.2020 23:00;183;69;114;Stellenweiser Regenfall;5;5;1
18.10.2020 00:00;152;62;90;Stellenweiser Regenfall;5;5;1
18.10.2020 01:00;109;38;71;Stellenweiser Regenfall;4;4;0
18.10.2020 02:00;56;22;34;Stellenweiser Regenfall;3;3;0
18.10.2020 03:00;66;19;47;Stellenweiser Regenfall;3;3;0
18.10.2020 04:00;17;9;8;Stellenweiser Regenfall;3;3;0
18.10.2020 05:00;23;7;16;Leicht bewölkt;2;2;0
18.10.2020 06:00;39;25;14;Leicht bewölkt;2;2;0
18.10.2020 07:00;45;19;26;Leicht bewölkt;3;3;0
18.10.2020 08:00;79;38;41;Leicht bewölkt;5;5;0
18.10.2020 09:00;174;112;62;Leicht bewölkt;6;6;0
18.10.2020 10:00;273;150;123;Leicht bewölkt;8;8;0
18.10.2020 11:00;288;141;147;Leicht bewölkt;9;9;0
18.10.2020 12:00;358;179;179;Leicht bewölkt;11;11;0
18.10.2020 13:00;428;214;214;Leicht bewölkt;11;11;0
18.10.2020 14:00;558;290;268;Leicht bewölkt;11;11;0
18.10.2020 15:00;589;288;301;Leicht bewölkt;11;11;0
18.10.2020 16:00;499;234;265;Leicht bewölkt;11;11;0
18.10.2020 17:00;560;280;280;Leicht bewölkt;10;10;0
18.10.2020 18:00;381;184;197;Leicht bewölkt;9;9;0
18.10.2020 19:00;279;118;161;Leicht bewölkt;8;8;0
18.10.2020 20:00;229;76;153;Bedeckt;8;8;0
18.10.2020 21:00;124;46;78;Bedeckt;7;7;0
18.10.2020 22:00;105;44;61;Bedeckt;7;7;0
18.10.2020 23:00;71;23;48;Leicht bewölkt;6;6;0
19.10.2020 00:00;24;11;13;Leicht bewölkt;6;6;0
19.10.2020 01:00;20;7;13;Leicht bewölkt;5;5;0
19.10.2020 02:00;2;1;1;Leicht bewölkt;5;5;0
19.10.2020 03:00;5;4;1;Leicht bewölkt;4;4;0
19.10.2020 04:00;7;6;1;Leicht bewölkt;4;3;0
19.10.2020 05:00;37;25;12;Leicht bewölkt;3;3;0
19.10.2020 06:00;196;118;78;Leicht bewölkt;3;2;0
19.10.2020 07:00;1069;685;384;Leicht bewölkt;4;4;0
19.10.2020 08:00;834;472;362;Leicht bewölkt;6;5;0
19.10.2020 09:00;665;370;295;Leicht bewölkt;7;7;0
19.10.2020 10:00;514;305;209;Leicht bewölkt;9;9;0
19.10.2020 11:00;666;297;369;Leicht bewölkt;10;11;0
19.10.2020 12:00;841;342;499;Leicht bewölkt;12;12;0
19.10.2020 13:00;1066;462;604;Leicht bewölkt;12;13;0
19.10.2020 14:00;923;436;487;Leicht bewölkt;12;13;0
19.10.2020 15:00;1120;539;581;Leicht bewölkt;13;13;0
19.10.2020 16:00;1178;548;630;Leicht bewölkt;12;12;0
19.10.2020 17:00;1232;521;711;Leicht bewölkt;11;11;0
19.10.2020 18:00;932;366;566;Leicht bewölkt;10;10;0
19.10.2020 19:00;553;232;321;Leicht bewölkt;8;8;0
19.10.2020 20:00;374;150;224;Leicht bewölkt;7;7;0
19.10.2020 21:00;206;83;123;Leicht bewölkt;6;6;0
19.10.2020 22:00;164;64;100;Leicht bewölkt;6;6;0
19.10.2020 23:00;59;24;35;Leicht bewölkt;6;6;0
20.10.2020 00:00;62;29;33;Leicht bewölkt;6;6;0
20.10.2020 01:00;21;10;11;Leicht bewölkt;5;5;0
20.10.2020 02:00;7;2;5;Leicht bewölkt;4;4;0
20.10.2020 03:00;7;6;1;Leicht bewölkt;4;3;0
20.10.2020 04:00;9;6;3;Leicht bewölkt;3;3;0
20.10.2020 05:00;57;41;16;Leicht bewölkt;3;2;0
20.10.2020 06:00;220;123;97;Leicht bewölkt;2;2;0
20.10.2020 07:00;1063;685;378;Leicht bewölkt;4;4;0
20.10.2020 08:00;852;493;359;Leicht bewölkt;6;6;0
20.10.2020 09:00;714;416;298;Leicht bewölkt;8;8;0
20.10.2020 10:00;553;310;243;Leicht bewölkt;10;10;0
20.10.2020 11:00;649;310;339;Leicht bewölkt;12;12;0
20.10.2020 12:00;849;359;490;Leicht bewölkt;14;14;0
20.10.2020 13:00;1052;440;612;Leicht bewölkt;14;14;0
20.10.2020 14:00;839;419;420;Leicht bewölkt;14;14;0
20.10.2020 15:00;1126;525;601;Leicht bewölkt;14;14;0
20.10.2020 16:00;1134;482;652;Leicht bewölkt;13;13;0
20.10.2020 17:00;1199;502;697;Leicht bewölkt;12;12;0
20.10.2020 18:00;930;415;515;Leicht bewölkt;11;11;0
20.10.2020 19:00;611;248;363;Leicht bewölkt;10;10;0
20.10.2020 20:00;375;156;219;Leicht bewölkt;9;9;0
20.10.2020 21:00;249;111;138;Leicht bewölkt;8;7;0
20.10.2020 22:00;209;93;116;Leicht bewölkt;8;7;0
20.10.2020 23:00;127;43;84;Leicht bewölkt;7;6;0
21.10.2020 00:00;53;17;36;Leicht bewölkt;7;6;0
21.10.2020 01:00;43;20;23;Leicht bewölkt;6;6;0
21.10.2020 02:00;22;7;15;Leicht bewölkt;6;6;0
21.10.2020 03:00;9;3;6;Leicht bewölkt;6;6;0
21.10.2020 04:00;12;9;3;Leicht bewölkt;6;6;0
21.10.2020 05:00;48;32;16;Leicht bewölkt;6;6;0
21.10.2020 06:00;186;113;73;Leicht bewölkt;6;6;0
21.10.2020 07:00;1017;623;394;Leicht bewölkt;8;7;0
21.10.2020 08:00;882;504;378;Leicht bewölkt;10;9;0
21.10.2020 09:00;689;418;271;Leicht bewölkt;11;11;0
21.10.2020 10:00;511;279;232;Leicht bewölkt;13;13;0
21.10.2020 11:00;691;345;346;Leicht bewölkt;15;14;0
21.10.2020 12:00;1054;439;615;Leicht bewölkt;16;16;0
21.10.2020 13:00;1126;587;539;Leicht bewölkt;16;16;0
21.10.2020 14:00;927;448;479;Leicht bewölkt;17;17;0
21.10.2020 15:00;1010;443;567;Leicht bewölkt;17;17;0
21.10.2020 16:00;1013;461;552;Leicht bewölkt;16;16;0
21.10.2020 17:00;1145;500;645;Leicht bewölkt;15;15;0
21.10.2020 18:00;924;394;530;Leicht bewölkt;14;14;0
21.10.2020 19:00;581;269;312;Leicht bewölkt;13;13;0
21.10.2020 20:00;437;186;251;Leicht bewölkt;12;12;0
21.10.2020 21:00;256;107;149;Leicht bewölkt;10;10;0
21.10.2020 22:00;235;95;140;Leicht bewölkt;10;9;0
21.10.2020 23:00;128;47;81;Leicht bewölkt;9;9;0
22.10.2020 00:00;67;28;39;Leicht bewölkt;8;8;0
22.10.2020 01:00;28;7;21;Leicht bewölkt;8;7;0
22.10.2020 02:00;9;5;4;Leicht bewölkt;7;7;0
22.10.2020 03:00;9;5;4;Leicht bewölkt;7;7;0
22.10.2020 04:00;12;8;4;Leicht bewölkt;7;7;0
22.10.2020 05:00;37;21;16;Leicht bewölkt;7;7;0
22.10.2020 06:00;206;124;82;Leicht bewölkt;6;6;0
22.10.2020 07:00;967;595;372;Leicht bewölkt;8;8;0
22.10.2020 08:00;832;478;354;Leicht bewölkt;9;10;0
22.10.2020 09:00;753;450;303;Leicht bewölkt;11;11;0
22.10.2020 10:00;539;316;223;Leicht bewölkt;12;13;0
22.10.2020 11:00;653;331;322;Leicht bewölkt;14;14;0
22.10.2020 12:00;855;409;446;Leicht bewölkt;15;16;0
22.10.2020 13:00;1067;492;575;Leicht bewölkt;15;16;0
22.10.2020 14:00;954;477;477;Leicht bewölkt;15;15;0
22.10.2020 15:00;1075;506;569;Leicht bewölkt;15;15;0
22.10.2020 16:00;1147;541;606;Leicht bewölkt;14;14;0
22.10.2020 17:00;1196;511;685;Leicht bewölkt;13;13;0
22.10.2020 18:00;1035;448;587;Leicht bewölkt;12;11;0
22.10.2020 19:00;642;265;377;Leicht bewölkt;12;11;0
22.10.2020 20:00;410;188;222;Leicht bewölkt;11;11;0
22.10.2020 21:00;281;128;153;Leicht bewölkt;10;10;0
22.10.2020 22:00;233;89;144;Leicht bewölkt;10;10;0
22.10.2020 23:00;168;61;107;Leicht bewölkt;10;10;0
23.10.2020 00:00;85;30;55;Leicht bewölkt;10;10;0
23.10.2020 01:00;61;16;45;Leicht bewölkt;11;11;0
23.10.2020 02:00;30;16;14;Bewölkt;11;11;0
23.10.2020 03:00;3;2;1;Bewölkt;11;11;0
23.10.2020 04:00;9;5;4;Bewölkt;11;11;0
23.10.2020 05:00;36;22;14;Bedeckt;11;11;0
23.10.2020 06:00;143;89;54;Bedeckt;11;11;0
23.10.2020 07:00;824;529;295;Bedeckt;11;11;0
23.10.2020 08:00;639;361;278;Bedeckt;11;11;6
23.10.2020 09:00;574;366;208;Bedeckt;12;12;8
23.10.2020 10:00;437;249;188;Bedeckt;12;12;4
23.10.2020 11:00;600;282;318;Leichter Regenfall;12;12;3
23.10.2020 12:00;672;270;402;Leichter Regenfall;13;13;4
23.10.2020 13:00;707;285;422;Leichter Regenfall;13;12;2
23.10.2020 14:00;541;234;307;Leichter Nebel;13;12;1
23.10.2020 15:00;473;226;247;Leichter Nebel;13;12;14
23.10.2020 16:00;483;223;260;Leichter Nebel;12;11;7
23.10.2020 17:00;480;232;248;Mäßiger Regenfall;12;11;9
23.10.2020 18:00;415;188;227;Mäßiger Regenfall;12;11;12
23.10.2020 19:00;289;133;156;Mäßiger Regenfall;12;11;6
23.10.2020 20:00;208;96;112;Leichter Regenfall;12;11;4
23.10.2020 21:00;121;55;66;Leichter Regenfall;11;11;5
23.10.2020 22:00;113;60;53;Leichter Regenfall;11;10;2
23.10.2020 23:00;102;39;63;Stellenweiser Nieselregen;10;10;2
24.10.2020 00:00;80;29;51;Stellenweiser Nieselregen;10;10;3
24.10.2020 01:00;65;22;43;Stellenweiser Nieselregen;10;9;1
24.10.2020 02:00;47;13;34;Stellenweiser Nieselregen;9;9;1
24.10.2020 03:00;36;6;30;Stellenweiser Nieselregen;9;8;2
24.10.2020 04:00;25;8;17;Stellenweiser Nieselregen;8;8;1
24.10.2020 05:00;27;10;17;Stellenweiser Regenfall;8;7;0
24.10.2020 06:00;35;28;7;Stellenweiser Regenfall;8;7;0
24.10.2020 07:00;68;42;26;Stellenweiser Regenfall;9;8;0
24.10.2020 08:00;196;129;67;Bewölkt;10;9;0
24.10.2020 09:00;312;200;112;Bewölkt;11;10;0
24.10.2020 10:00;484;269;215;Bewölkt;12;11;0
24.10.2020 11:00;621;347;274;Leicht bewölkt;13;12;0
24.10.2020 12:00;575;305;270;Leicht bewölkt;14;13;0
24.10.2020 13:00;651;341;310;Leicht bewölkt;14;14;0
24.10.2020 14:00;701;350;351;Leicht bewölkt;14;14;0
24.10.2020 15:00;735;361;374;Leicht bewölkt;15;15;0
24.10.2020 16:00;761;335;426;Leicht bewölkt;14;14;0
24.10.2020 17:00;700;295;405;Leicht bewölkt;13;14;0
24.10.2020 18:00;678;289;389;Leicht bewölkt;13;13;0
24.10.2020 19:00;464;225;239;Leicht bewölkt;12;12;0
24.10.2020 20:00;295;126;169;Leicht bewölkt;10;10;0
24.10.2020 21:00;225;84;141;Leicht bewölkt;9;9;0
24.10.2020 22:00;173;72;101;Leicht bewölkt;9;9;0
24.10.2020 23:00;183;81;102;Leicht bewölkt;8;8;0
25.10.2020 00:00;136;59;77;Leicht bewölkt;8;8;0
25.10.2020 01:00;95;29;66;Leicht bewölkt;7;7;0
25.10.2020 02:00;107;35;72;Leicht bewölkt;7;7;0
25.10.2020 03:00;42;9;33;Leicht bewölkt;7;6;0
25.10.2020 04:00;11;7;4;Leicht bewölkt;6;6;0
25.10.2020 05:00;21;8;13;Leicht bewölkt;6;6;0
25.10.2020 06:00;35;25;10;Leicht bewölkt;6;6;0
25.10.2020 07:00;52;24;28;Leicht bewölkt;7;7;0
25.10.2020 08:00;93;38;55;Leicht bewölkt;9;9;0
25.10.2020 09:00;206;118;88;Leicht bewölkt;10;10;0
25.10.2020 10:00;274;138;136;Leicht bewölkt;12;12;0
25.10.2020 11:00;300;145;155;Leicht bewölkt;14;14;0
25.10.2020 12:00;366;173;193;Leicht bewölkt;15;15;0
25.10.2020 13:00;435;194;241;Leicht bewölkt;15;16;0
25.10.2020 14:00;547;265;282;Leicht bewölkt;15;16;0
25.10.2020 15:00;572;294;278;Leicht bewölkt;16;16;0
25.10.2020 16:00;561;289;272;Leicht bewölkt;14;15;0
25.10.2020 17:00;554;270;284;Leicht bewölkt;13;13;0
25.10.2020 18:00;301;143;158;Leicht bewölkt;12;12;0
25.10.2020 19:00;227;126;101;Leicht bewölkt;11;11;0
25.10.2020 20:00;183;71;112;Leicht bewölkt;10;10;0
25.10.2020 21:00;128;50;78;Leicht bewölkt;9;9;0
25.10.2020 22:00;90;42;48;Leicht bewölkt;8;8;0
25.10.2020 23:00;71;20;51;Leicht bewölkt;8;8;0
26.10.2020 00:00;47;26;21;Leicht bewölkt;8;8;0
26.10.2020 01:00;17;6;11;Leicht bewölkt;8;7;0
26.10.2020 02:00;10;6;4;Leicht bewölkt;7;7;0
26.10.2020 03:00;2;1;1;Leicht bewölkt;7;6;0
26.10.2020 04:00;0;0;0;Leicht bewölkt;7;6;0
26.10.2020 05:00;44;29;15;Leicht bewölkt;7;6;1
26.10.2020 06:00;183;115;68;Leicht bewölkt;7;7;1
26.10.2020 07:00;274;153;121;Leicht bewölkt;7;7;0
26.10.2020 08:00;345;198;147;Nieselregen;8;7;13
26.10.2020 09:00;221;115;106;Nieselregen;8;7;17
26.10.2020 10:00;203;109;94;Nieselregen;8;7;8
26.10.2020 11:00;234;115;119;Mäßiger Regenfall;8;7;33
26.10.2020 12:00;249;113;136;Mäßiger Regenfall;8;6;44
26.10.2020 13:00;283;133;150;Mäßiger Regenfall;8;6;22
26.10.2020 14:00;236;123;113;Starker Regenfall;7;6;32
26.10.2020 15:00;299;160;139;Starker Regenfall;7;6;43
26.10.2020 16:00;373;168;205;Starker Regenfall;7;6;21
26.10.2020 17:00;380;165;215;Starker Regenfall;7;6;28
26.10.2020 18:00;344;154;190;Starker Regenfall;6;6;38
26.10.2020 19:00;246;121;125;Starker Regenfall;6;5;19
26.10.2020 20:00;192;83;109;Starker Regenfall;6;4;18
26.10.2020 21:00;120;54;66;Starker Regenfall;6;4;24
26.10.2020 22:00;94;36;58;Starker Regenfall;6;4;12
26.10.2020 23:00;51;19;32;Nieselregen;6;4;0
27.10.2020 00:00;29;10;19;Nieselregen;6;4;0
27.10.2020 01:00;23;14;9;Nieselregen;6;4;0
27.10.2020 02:00;16;9;7;Bedeckt;6;4;0
27.10.2020 03:00;6;5;1;Bedeckt;6;5;0
27.10.2020 04:00;7;3;4;Bedeckt;5;4;0
27.10.2020 05:00;51;36;15;Bedeckt;5;4;0
27.10.2020 06:00;169;109;60;Bedeckt;5;4;0
27.10.2020 07:00;450;263;187;Bedeckt;6;5;0
27.10.2020 08:00;613;344;269;Bedeckt;6;5;0
27.10.2020 09:00;499;312;187;Bedeckt;7;6;0
27.10.2020 10:00;553;310;243;Bedeckt;8;7;0
27.10.2020 11:00;642;329;313;Leicht bewölkt;9;8;0
27.10.2020 12:00;692;317;375;Leicht bewölkt;10;9;0
27.10.2020 13:00;700;346;354;Leicht bewölkt;10;9;0
27.10.2020 14:00;744;383;361;Stellenweiser Regenfall;11;10;0
27.10.2020 15:00;827;403;424;Stellenweiser Regenfall;11;10;0
27.10.2020 16:00;984;436;548;Stellenweiser Regenfall;10;10;0
27.10.2020 17:00;917;403;514;Stellenweiser Regenfall;10;10;0
27.10.2020 18:00;713;295;418;Stellenweiser Regenfall;10;9;0
27.10.2020 19:00;476;213;263;Stellenweiser Regenfall;9;9;0
27.10.2020 20:00;336;145;191;Leicht bewölkt;8;8;0
27.10.2020 21:00;205;74;131;Leicht bewölkt;8;8;0
27.10.2020 22:00;194;71;123;Leicht bewölkt;6;6;0
27.10.2020 23:00;131;37;94;Leicht bewölkt;5;4;0
28.10.2020 00:00;44;16;28;Leicht bewölkt;4;2;0
28.10.2020 01:00;27;10;17;Leicht bewölkt;4;2;0
28.10.2020 02:00;12;9;3;Leicht bewölkt;5;3;0
28.10.2020 03:00;9;1;8;Leicht bewölkt;5;4;0
28.10.2020 04:00;14;9;5;Leicht bewölkt;5;4;0
28.10.2020 05:00;46;30;16;Leicht bewölkt;5;4;0
28.10.2020 06:00;164;92;72;Leicht bewölkt;6;5;0
28.10.2020 07:00;330;194;136;Leicht bewölkt;6;5;0
28.10.2020 08:00;563;341;222;Bewölkt;6;5;1
28.10.2020 09:00;461;275;186;Bewölkt;7;6;1
28.10.2020 10:00;428;240;188;Bewölkt;7;7;1
28.10.2020 11:00;490;258;232;Stellenweiser Nieselregen;8;7;1
28.10.2020 12:00;586;275;311;Stellenweiser Nieselregen;8;8;1
28.10.2020 13:00;616;307;309;Stellenweiser Nieselregen;9;9;1
28.10.2020 14:00;610;325;285;Stellenweiser Nieselregen;9;9;0
28.10.2020 15:00;739;345;394;Stellenweiser Nieselregen;10;10;0
28.10.2020 16:00;786;384;402;Stellenweiser Nieselregen;10;9;0
28.10.2020 17:00;873;377;496;Stellenweiser Regenfall;9;9;0
28.10.2020 18:00;670;264;406;Stellenweiser Regenfall;9;8;0
28.10.2020 19:00;439;191;248;Stellenweiser Regenfall;7;6;0
28.10.2020 20:00;347;153;194;Leicht bewölkt;6;5;0
28.10.2020 21:00;176;79;97;Leicht bewölkt;4;4;0
28.10.2020 22:00;197;85;112;Leicht bewölkt;6;5;0
28.10.2020 23:00;147;45;102;Bedeckt;7;6;0
29.10.2020 00:00;54;31;23;Bedeckt;9;8;0
29.10.2020 01:00;48;19;29;Bedeckt;9;8;0
29.10.2020 02:00;14;7;7;Bewölkt;9;7;0
29.10.2020 03:00;11;3;8;Bewölkt;9;7;0
29.10.2020 04:00;12;5;7;Bewölkt;9;7;0
29.10.2020 05:00;46;26;20;Stellenweiser Regenfall;9;7;0
29.10.2020 06:00;124;73;51;Stellenweiser Regenfall;9;7;0
29.10.2020 07:00;299;174;125;Stellenweiser Regenfall;9;7;0
29.10.2020 08:00;457;273;184;Bedeckt;9;7;1
29.10.2020 09:00;399;224;175;Bedeckt;10;7;1
29.10.2020 10:00;334;195;139;Bedeckt;10;8;1
29.10.2020 11:00;393;225;168;Nieselregen;11;8;1
29.10.2020 12:00;533;253;280;Nieselregen;11;9;1
29.10.2020 13:00;532;267;265;Nieselregen;11;9;0
29.10.2020 14:00;579;293;286;Bedeckt;11;9;1
29.10.2020 15:00;592;312;280;Bedeckt;11;10;2
29.10.2020 16:00;718;320;398;Bedeckt;11;9;1
29.10.2020 17:00;689;325;364;Leichter Regenschauer;10;9;1
29.10.2020 18:00;600;257;343;Leichter Regenschauer;10;9;1
29.10.2020 19:00;460;209;251;Leichter Regenschauer;9;8;0
29.10.2020 20:00;303;147;156;Bedeckt;8;7;1
29.10.2020 21:00;178;69;109;Bedeckt;7;6;1
29.10.2020 22:00;184;53;131;Bedeckt;7;7;1
29.10.2020 23:00;147;49;98;Stellenweiser Regenfall;7;7;0
30.10.2020 00:00;52;20;32;Stellenweiser Regenfall;7;7;0
30.10.2020 01:00;29;17;12;Stellenweiser Regenfall;8;8;0
30.10.2020 02:00;23;13;10;Bedeckt;9;8;1
30.10.2020 03:00;10;7;3;Bedeckt;10;9;2
30.10.2020 04:00;22;9;13;Bedeckt;10;9;1
30.10.2020 05:00;48;31;17;Nieselregen;10;9;1
30.10.2020 06:00;152;101;51;Nieselregen;10;9;1
30.10.2020 07:00;375;213;162;Nieselregen;10;10;0
30.10.2020 08:00;578;338;240;Bedeckt;11;10;0
30.10.2020 09:00;549;338;211;Bedeckt;12;11;0
30.10.2020 10:00;602;335;267;Bedeckt;12;12;0
30.10.2020 11:00;712;396;316;Bewölkt;13;13;0
30.10.2020 12:00;749;337;412;Bewölkt;14;14;0
30.10.2020 13:00;731;343;388;Bewölkt;14;14;0
30.10.2020 14:00;790;368;422;Bewölkt;14;14;0
30.10.2020 15:00;834;462;372;Bewölkt;15;15;0
30.10.2020 16:00;797;397;400;Bewölkt;14;14;0
30.10.2020 17:00;819;375;444;Leicht bewölkt;13;13;0
30.10.2020 18:00;652;286;366;Leicht bewölkt;12;12;0
30.10.2020 19:00;513;240;273;Leicht bewölkt;11;11;0
30.10.2020 20:00;296;141;155;Leicht bewölkt;10;10;0
30.10.2020 21:00;258;125;133;Leicht bewölkt;9;9;0
30.10.2020 22:00;186;62;124;Leicht bewölkt;9;9;0
30.10.2020 23:00;199;68;131;Leicht bewölkt;8;8;0
31.10.2020 00:00;92;38;54;Leicht bewölkt;8;8;0
31.10.2020 01:00;76;33;43;Leicht bewölkt;7;7;0
31.10.2020 02:00;28;8;20;Leicht bewölkt;7;7;0
31.10.2020 03:00;19;8;11;Leicht bewölkt;7;7;0
31.10.2020 04:00;30;15;15;Leicht bewölkt;7;7;0
31.10.2020 05:00;26;11;15;Leicht bewölkt;7;7;0
31.10.2020 06:00;53;29;24;Leicht bewölkt;7;7;0
31.10.2020 07:00;82;38;44;Leicht bewölkt;8;8;0
31.10.2020 08:00;172;91;81;Leicht bewölkt;9;9;0
31.10.2020 09:00;316;192;124;Leicht bewölkt;10;10;0
31.10.2020 10:00;513;299;214;Leicht bewölkt;11;11;0
31.10.2020 11:00;599;313;286;Leicht bewölkt;12;12;0
31.10.2020 12:00;593;305;288;Leicht bewölkt;13;13;0
31.10.2020 13:00;634;333;301;Leicht bewölkt;14;14;0
31.10.2020 14:00;682;298;384;Bedeckt;14;14;0
31.10.2020 15:00;632;292;340;Bedeckt;14;14;0
31.10.2020 16:00;610;293;317;Bedeckt;13;14;0
31.10.2020 17:00;613;256;357;Leicht bewölkt;13;13;0
31.10.2020 18:00;488;200;288;Leicht bewölkt;12;12;0
31.10.2020 19:00;327;158;169;Leicht bewölkt;11;11;0
31.10.2020 20:00;299;139;160;Sonnig;10;10;0
31.10.2020 21:00;210;89;121;Sonnig;9;9;0
31.10.2020 22:00;173;61;112;Sonnig;9;8;0
31.10.2020 23:00;241;83;158;Sonnig;8;8;0
01.11.2020 00:00;144;68;76;Sonnig;8;7;0
01.11.2020 01:00;128;55;73;Sonnig;8;7;0
01.11.2020 02:00;58;25;33;Bedeckt;7;7;0
01.11.2020 03:00;44;19;25;Bedeckt;7;7;0
01.11.2020 04:00;31;15;16;Bedeckt;7;7;0
01.11.2020 05:00;15;7;8;Leicht bewölkt;7;7;0
01.11.2020 06:00;24;17;7;Leicht bewölkt;7;7;0
01.11.2020 07:00;35;23;12;Leicht bewölkt;8;8;0
01.11.2020 08:00;89;49;40;Leicht bewölkt;9;9;0
01.11.2020 09:00;140;91;49;Leicht bewölkt;10;10;0
01.11.2020 10:00;160;80;80;Leicht bewölkt;10;10;0
01.11.2020 11:00;160;73;87;Leicht bewölkt;11;11;0
01.11.2020 12:00;162;77;85;Leicht bewölkt;11;11;0
01.11.2020 13:00;198;101;97;Leicht bewölkt;11;12;0
01.11.2020 14:00;296;156;140;Bedeckt;12;12;0
01.11.2020 15:00;353;177;176;Bedeckt;12;12;0
01.11.2020 16:00;334;166;168;Bedeckt;12;12;0
01.11.2020 17:00;317;160;157;Bedeckt;12;12;0
01.11.2020 18:00;244;133;111;Bedeckt;12;12;0
01.11.2020 19:00;196;103;93;Bedeckt;11;11;0
01.11.2020 20:00;160;76;84;Bedeckt;9;9;0
01.11.2020 21:00;113;36;77;Bedeckt;8;8;0
01.11.2020 22:00;95;39;56;Bedeckt;9;9;0
01.11.2020 23:00;66;21;45;Leicht bewölkt;11;10;0
02.11.2020 00:00;42;19;23;Leicht bewölkt;12;12;0
02.11.2020 01:00;15;4;11;Leicht bewölkt;12;12;0
02.11.2020 02:00;10;5;5;Bewölkt;12;12;1
02.11.2020 03:00;4;1;3;Bewölkt;12;12;1
02.11.2020 04:00;12;9;3;Bewölkt;12;12;0
02.11.2020 05:00;41;23;18;Stellenweiser Nieselregen;12;12;0
02.11.2020 06:00;186;119;67;Stellenweiser Nieselregen;12;12;0
02.11.2020 07:00;1030;702;328;Stellenweiser Nieselregen;12;13;0
02.11.2020 08:00;807;438;369;Bedeckt;13;13;1
02.11.2020 09:00;575;343;232;Bedeckt;13;13;1
02.11.2020 10:00;451;247;204;Bedeckt;14;14;1
02.11.2020 11:00;498;240;258;Stellenweiser Nieselregen;15;16;2
02.11.2020 12:00;679;322;357;Stellenweiser Nieselregen;17;17;2
02.11.2020 13:00;1011;439;572;Stellenweiser Nieselregen;17;17;1
02.11.2020 14:00;846;405;441;Stellenweiser Regenfall;17;17;1
02.11.2020 15:00;1071;496;575;Stellenweiser Regenfall;18;18;1
02.11.2020 16:00;1001;443;558;Stellenweiser Regenfall;17;17;0
02.11.2020 17:00;942;404;538;Leicht bewölkt;15;16;0
02.11.2020 18:00;562;224;338;Leicht bewölkt;14;15;0
02.11.2020 19:00;363;160;203;Leicht bewölkt;13;13;0
02.11.2020 20:00;207;94;113;Leicht bewölkt;11;11;0
02.11.2020 21:00;116;52;64;Leicht bewölkt;9;9;0
02.11.2020 22:00;74;35;39;Leicht bewölkt;10;10;0
02.11.2020 23:00;60;34;26;Bewölkt;12;12;0
03.11.2020 00:00;25;10;15;Bewölkt;13;13;0
03.11.2020 01:00;9;4;5;Bewölkt;13;13;0
03.11.2020 02:00;7;4;3;Bedeckt;13;14;2
03.11.2020 03:00;3;0;3;Bedeckt;14;14;2
03.11.2020 04:00;10;9;1;Bedeckt;13;13;1
03.11.2020 05:00;46;32;14;Nieselregen;13;13;1
03.11.2020 06:00;166;110;56;Nieselregen;13;12;13
03.11.2020 07:00;916;600;316;Nieselregen;12;11;6
03.11.2020 08:00;729;418;311;Mäßiger Regenfall;12;11;8
03.11.2020 09:00;601;353;248;Mäßiger Regenfall;11;10;11
03.11.2020 10:00;391;210;181;Mäßiger Regenfall;11;10;6
03.11.2020 11:00;546;265;281;Leichter Regenfall;11;10;1
03.11.2020 12:00;610;262;348;Leichter Regenfall;11;10;13
03.11.2020 13:00;758;296;462;Leichter Regenfall;11;10;6
03.11.2020 14:00;604;258;346;Mäßiger Regenfall;11;10;9
03.11.2020 15:00;889;417;472;Mäßiger Regenfall;11;10;12
03.11.2020 16:00;691;316;375;Mäßiger Regenfall;10;10;6
03.11.2020 17:00;622;256;366;Leichter Regenfall;9;9;9
03.11.2020 18:00;443;198;245;Leichter Regenfall;9;8;12
03.11.2020 19:00;281;116;165;Leichter Regenfall;7;7;6
03.11.2020 20:00;135;63;72;Mäßiger Regenfall;5;5;6
03.11.2020 21:00;90;35;55;Mäßiger Regenfall;4;4;8
03.11.2020 22:00;71;36;35;Mäßiger Regenfall;5;4;4
03.11.2020 23:00;44;24;20;Leichter Regenfall;5;5;3
04.11.2020 00:00;20;7;13;Leichter Regenfall;6;6;4
04.11.2020 01:00;7;4;3;Leichter Regenfall;7;6;2
04.11.2020 02:00;7;2;5;Leichter Regenfall;7;6;2
04.11.2020 03:00;7;2;5;Leichter Regenfall;8;6;2
04.11.2020 04:00;13;9;4;Leichter Regenfall;7;5;1
04.11.2020 05:00;37;28;9;Nieselregen;7;5;1
04.11.2020 06:00;150;97;53;Nieselregen;7;4;2
04.11.2020 07:00;772;484;288;Nieselregen;6;4;1
04.11.2020 08:00;582;339;243;Nieselregen;6;3;2
04.11.2020 09:00;391;251;140;Nieselregen;6;3;3
04.11.2020 10:00;245;120;125;Nieselregen;6;3;1
04.11.2020 11:00;359;195;164;Nieselregen;7;4;2
04.11.2020 12:00;478;215;263;Nieselregen;7;4;3
04.11.2020 13:00;792;364;428;Nieselregen;7;5;2
04.11.2020 14:00;576;286;290;Nieselregen;7;5;1
04.11.2020 15:00;758;330;428;Nieselregen;8;5;1
04.11.2020 16:00;686;336;350;Nieselregen;8;5;0
04.11.2020 17:00;602;258;344;Bedeckt;7;5;0
04.11.2020 18:00;500;215;285;Bedeckt;7;5;0
04.11.2020 19:00;302;134;168;Bedeckt;7;5;0
04.11.2020 20:00;211;92;119;Stellenweiser Regenfall;7;5;0
04.11.2020 21:00;115;45;70;Stellenweiser Regenfall;7;5;0
04.11.2020 22:00;71;46;25;Stellenweiser Regenfall;6;4;0
04.11.2020 23:00;60;27;33;Bedeckt;5;3;0
05.11.2020 00:00;29;14;15;Bedeckt;4;2;0
05.11.2020 01:00;17;8;9;Bedeckt;4;2;0
05.11.2020 02:00;7;3;4;Bedeckt;5;2;0
05.11.2020 03:00;3;2;1;Bedeckt;5;2;0
05.11.2020 04:00;12;6;6;Bedeckt;5;2;0
05.11.2020 05:00;44;26;18;Leicht bewölkt;4;2;0
05.11.2020 06:00;182;113;69;Leicht bewölkt;4;1;0
05.11.2020 07:00;927;585;342;Leicht bewölkt;5;2;0
05.11.2020 08:00;734;420;314;Bedeckt;6;3;0
05.11.2020 09:00;579;353;226;Bedeckt;7;4;0
05.11.2020 10:00;480;265;215;Bedeckt;8;6;0
05.11.2020 11:00;530;253;277;Bedeckt;9;7;0
05.11.2020 12:00;621;288;333;Bedeckt;10;8;0
05.11.2020 13:00;860;328;532;Bedeckt;10;8;0
05.11.2020 14:00;718;325;393;Bewölkt;10;8;0
05.11.2020 15:00;981;467;514;Bewölkt;10;9;0
05.11.2020 16:00;832;400;432;Bewölkt;9;7;0
05.11.2020 17:00;820;352;468;Leicht bewölkt;8;6;0
05.11.2020 18:00;610;232;378;Leicht bewölkt;7;5;0
05.11.2020 19:00;360;149;211;Leicht bewölkt;6;4;0
05.11.2020 20:00;206;77;129;Leicht bewölkt;6;3;0
05.11.2020 21:00;116;44;72;Leicht bewölkt;5;2;0
05.11.2020 22:00;113;61;52;Leicht bewölkt;5;2;0
05.11.2020 23:00;59;28;31;Leicht bewölkt;4;2;0
06.11.2020 00:00;43;20;23;Leicht bewölkt;4;2;0
06.11.2020 01:00;15;11;4;Leicht bewölkt;4;2;0
06.11.2020 02:00;12;8;4;Leichter Nebel;4;3;0
06.11.2020 03:00;6;3;3;Leichter Nebel;4;3;0
06.11.2020 04:00;12;7;5;Leichter Nebel;4;3;0
06.11.2020 05:00;37;24;13;Bewölkt;4;3;0
06.11.2020 06:00;170;118;52;Bewölkt;4;3;0
06.11.2020 07:00;865;561;304;Bewölkt;5;4;0
06.11.2020 08:00;699;385;314;Bewölkt;6;5;0
06.11.2020 09:00;634;404;230;Bewölkt;7;6;0
06.11.2020 10:00;477;255;222;Bewölkt;8;7;0
06.11.2020 11:00;580;259;321;Bewölkt;9;8;0
06.11.2020 12:00;721;322;399;Bewölkt;9;9;0
06.11.2020 13:00;902;363;539;Bewölkt;9;9;0
06.11.2020 14:00;746;332;414;Leicht bewölkt;9;8;0
06.11.2020 15:00;730;339;391;Leicht bewölkt;9;8;0
06.11.2020 16:00;704;317;387;Leicht bewölkt;8;7;0
06.11.2020 17:00;652;264;388;Leicht bewölkt;7;6;0
06.11.2020 18:00;528;216;312;Leicht bewölkt;6;5;0
06.11.2020 19:00;288;109;179;Leicht bewölkt;5;4;0
06.11.2020 20:00;223;91;132;Leichter Nebel;5;4;0
06.11.2020 21:00;129;60;69;Leichter Nebel;4;3;0
06.11.2020 22:00;80;36;44;Leichter Nebel;4;4;0
06.11.2020 23:00;88;45;43;Leichter Nebel;4;4;0
07.11.2020 00:00;127;79;48;Leichter Nebel;4;4;0
07.11.2020 01:00;59;24;35;Leichter Nebel;4;4;0
07.11.2020 02:00;17;9;8;Leicht bewölkt;4;4;0
07.11.2020 03:00;17;7;10;Leicht bewölkt;4;4;0
07.11.2020 04:00;15;8;7;Leicht bewölkt;5;5;0
07.11.2020 05:00;25;12;13;Leicht bewölkt;5;5;0
07.11.2020 06:00;39;27;12;Leicht bewölkt;5;5;0
07.11.2020 07:00;82;55;27;Leicht bewölkt;6;6;0
07.11.2020 08:00;144;80;64;Sonnig;8;8;0
07.11.2020 09:00;304;197;107;Sonnig;9;10;0
07.11.2020 10:00;404;229;175;Sonnig;11;11;0
07.11.2020 11:00;498;276;222;Sonnig;13;13;0
07.11.2020 12:00;537;279;258;Sonnig;14;15;0
07.11.2020 13:00;514;238;276;Sonnig;14;14;0
07.11.2020 14:00;605;298;307;Sonnig;14;14;0
07.11.2020 15:00;544;258;286;Sonnig;14;14;0
07.11.2020 16:00;531;225;306;Sonnig;13;13;0
07.11.2020 17:00;537;245;292;Sonnig;12;12;0
07.11.2020 18:00;378;136;242;Sonnig;11;11;0
07.11.2020 19:00;226;91;135;Sonnig;10;10;0
07.11.2020 20:00;177;78;99;Sonnig;9;9;0
07.11.2020 21:00;125;58;67;Sonnig;8;8;0
07.11.2020 22:00;88;44;44;Sonnig;7;7;0
07.11.2020 23:00;118;60;58;Leicht bewölkt;6;6;0
08.11.2020 00:00;79;45;34;Leicht bewölkt;6;6;0
08.11.2020 01:00;43;28;15;Leicht bewölkt;5;5;0
08.11.2020 02:00;29;12;17;Leicht bewölkt;5;5;0
08.11.2020 03:00;24;8;16;Leicht bewölkt;5;5;0
08.11.2020 04:00;5;4;1;Leicht bewölkt;4;4;0
08.11.2020 05:00;9;2;7;Leicht bewölkt;4;4;0
08.11.2020 06:00;20;15;5;Leicht bewölkt;3;3;0
08.11.2020 07:00;20;13;7;Leicht bewölkt;5;4;0
08.11.2020 08:00;55;30;25;Leicht bewölkt;6;6;0
08.11.2020 09:00;108;66;42;Leicht bewölkt;7;7;0
08.11.2020 10:00;150;74;76;Leicht bewölkt;9;9;0
08.11.2020 11:00;198;90;108;Leicht bewölkt;10;10;0
08.11.2020 12:00;191;87;104;Leicht bewölkt;11;12;0
08.11.2020 13:00;292;124;168;Leicht bewölkt;12;12;0
08.11.2020 14:00;322;150;172;Leicht bewölkt;12;12;0
08.11.2020 15:00;316;140;176;Leicht bewölkt;12;12;0
08.11.2020 16:00;340;157;183;Leicht bewölkt;11;11;0
08.11.2020 17:00;369;178;191;Sonnig;10;10;0
08.11.2020 18:00;189;85;104;Sonnig;9;9;0
08.11.2020 19:00;152;82;70;Sonnig;8;8;0
08.11.2020 20:00;124;61;63;Leicht bewölkt;7;7;0
08.11.2020 21:00;81;48;33;Leicht bewölkt;6;6;0
08.11.2020 22:00;74;33;41;Leicht bewölkt;6;6;0
08.11.2020 23:00;32;17;15;Bewölkt;6;6;0
09.11.2020 00:00;19;11;8;Bewölkt;5;5;0
09.11.2020 01:00;7;4;3;Bewölkt;5;5;0
09.11.2020 02:00;6;2;4;Leicht bewölkt;5;5;0
09.11.2020 03:00;5;2;3;Leicht bewölkt;5;5;0
09.11.2020 04:00;4;3;1;Leicht bewölkt;5;5;0
09.11.2020 05:00;39;22;17;Leicht bewölkt;4;4;0
09.11.2020 06:00;171;106;65;Leicht bewölkt;4;4;0
09.11.2020 07:00;954;611;343;Leicht bewölkt;6;6;0
09.11.2020 08:00;653;371;282;Leicht bewölkt;7;7;0
09.11.2020 09:00;565;327;238;Leicht bewölkt;9;9;0
09.11.2020 10:00;409;226;183;Leicht bewölkt;10;10;0
09.11.2020 11:00;486;224;262;Leicht bewölkt;12;12;0
09.11.2020 12:00;648;298;350;Leicht bewölkt;14;14;0
09.11.2020 13:00;824;354;470;Leicht bewölkt;13;13;0
09.11.2020 14:00;659;310;349;Leicht bewölkt;13;13;0
09.11.2020 15:00;956;442;514;Leicht bewölkt;13;13;0
09.11.2020 16:00;889;425;464;Leicht bewölkt;12;12;0
09.11.2020 17:00;772;346;426;Leicht bewölkt;11;11;0
09.11.2020 18:00;603;243;360;Leicht bewölkt;9;9;0
09.11.2020 19:00;340;162;178;Leicht bewölkt;9;9;0
09.11.2020 20:00;230;84;146;Leicht bewölkt;8;8;0
09.11.2020 21:00;131;55;76;Leicht bewölkt;7;7;0
09.11.2020 22:00;76;36;40;Leicht bewölkt;7;7;0
09.11.2020 23:00;44;20;24;Leicht bewölkt;7;7;0
10.11.2020 00:00;28;15;13;Leicht bewölkt;7;7;0
10.11.2020 01:00;7;2;5;Leicht bewölkt;6;6;0
10.11.2020 02:00;6;3;3;Leicht bewölkt;6;6;0
10.11.2020 03:00;0;0;0;Leicht bewölkt;6;6;0
10.11.2020 04:00;14;10;4;Leicht bewölkt;5;5;0
10.11.2020 05:00;41;29;12;Leicht bewölkt;5;5;0
10.11.2020 06:00;191;121;70;Leicht bewölkt;5;5;0
10.11.2020 07:00;931;604;327;Leicht bewölkt;6;6;0
10.11.2020 08:00;724;399;325;Leicht bewölkt;7;7;0
10.11.2020 09:00;626;391;235;Leicht bewölkt;8;8;0
10.11.2020 10:00;435;252;183;Leicht bewölkt;9;9;0
10.11.2020 11:00;498;242;256;Leicht bewölkt;11;11;0
10.11.2020 12:00;631;277;354;Leicht bewölkt;12;12;0
10.11.2020 13:00;816;337;479;Leicht bewölkt;12;12;0
10.11.2020 14:00;671;304;367;Leicht bewölkt;11;11;0
10.11.2020 15:00;844;402;442;Leicht bewölkt;11;11;0
10.11.2020 16:00;817;383;434;Leicht bewölkt;10;10;0
10.11.2020 17:00;823;375;448;Leicht bewölkt;9;9;0
10.11.2020 18:00;606;248;358;Leicht bewölkt;8;8;0
10.11.2020 19:00;346;150;196;Leicht bewölkt;8;8;0
10.11.2020 20:00;206;81;125;Leicht bewölkt;7;7;0
10.11.2020 21:00;113;52;61;Leicht bewölkt;6;6;0
10.11.2020 22:00;85;42;43;Leicht bewölkt;6;6;0
10.11.2020 23:00;56;24;32;Leicht bewölkt;6;6;0
11.11.2020 00:00;37;21;16;Leicht bewölkt;6;6;0
11.11.2020 01:00;13;9;4;Leicht bewölkt;6;6;0
11.11.2020 02:00;4;2;2;Leicht bewölkt;5;5;0
11.11.2020 03:00;6;2;4;Leicht bewölkt;5;5;0
11.11.2020 04:00;16;12;4;Leicht bewölkt;5;5;0
11.11.2020 05:00;46;34;12;Leicht bewölkt;4;4;0
11.11.2020 06:00;152;99;53;Leicht bewölkt;4;4;0
11.11.2020 07:00;925;576;349;Leicht bewölkt;5;5;0
11.11.2020 08:00;709;409;300;Leicht bewölkt;7;7;0
11.11.2020 09:00;511;339;172;Leicht bewölkt;8;8;0
11.11.2020 10:00;431;236;195;Leicht bewölkt;9;9;0
11.11.2020 11:00;463;239;224;Leicht bewölkt;11;11;0
11.11.2020 12:00;614;257;357;Leicht bewölkt;12;12;0
11.11.2020 13:00;963;459;504;Leicht bewölkt;12;12;0
11.11.2020 14:00;649;338;311;Leicht bewölkt;12;12;0
11.11.2020 15:00;884;377;507;Leicht bewölkt;12;12;0
11.11.2020 16:00;792;357;435;Leicht bewölkt;11;11;0
11.11.2020 17:00;777;336;441;Leicht bewölkt;10;10;0
11.11.2020 18:00;612;251;361;Leicht bewölkt;9;9;0
11.11.2020 19:00;400;167;233;Leicht bewölkt;8;8;0
11.11.2020 20:00;214;71;143;Leicht bewölkt;7;7;0
11.11.2020 21:00;124;49;75;Leicht bewölkt;7;7;0
11.11.2020 22:00;87;47;40;Leicht bewölkt;6;6;0
11.11.2020 23:00;79;43;36;Leicht bewölkt;5;5;0
12.11.2020 00:00;46;23;23;Leicht bewölkt;5;5;0
12.11.2020 01:00;22;19;3;Leicht bewölkt;5;5;0
12.11.2020 02:00;6;3;3;Leicht bewölkt;5;5;0
12.11.2020 03:00;7;4;3;Leicht bewölkt;4;4;0
12.11.2020 04:00;15;11;4;Leicht bewölkt;4;4;0
12.11.2020 05:00;42;29;13;Leicht bewölkt;4;4;0
12.11.2020 06:00;143;86;57;Leicht bewölkt;4;4;0
12.11.2020 07:00;957;610;347;Leicht bewölkt;5;5;0
12.11.2020 08:00;713;414;299;Leicht bewölkt;6;6;0
12.11.2020 09:00;551;323;228;Leicht bewölkt;7;8;0
12.11.2020 10:00;404;234;170;Leicht bewölkt;8;9;0
12.11.2020 11:00;518;256;262;Leicht bewölkt;10;10;0
12.11.2020 12:00;668;304;364;Leicht bewölkt;11;11;0
12.11.2020 13:00;936;399;537;Leicht bewölkt;10;11;0
12.11.2020 14:00;771;367;404;Bedeckt;10;10;0
12.11.2020 15:00;1023;428;595;Bedeckt;10;10;0
12.11.2020 16:00;936;451;485;Bedeckt;9;9;0
12.11.2020 17:00;917;386;531;Leicht bewölkt;9;9;0
12.11.2020 18:00;633;253;380;Leicht bewölkt;8;8;0
12.11.2020 19:00;347;137;210;Leicht bewölkt;7;8;0
12.11.2020 20:00;211;77;134;Leicht bewölkt;7;7;0
12.11.2020 21:00;147;55;92;Leicht bewölkt;7;7;0
12.11.2020 22:00;114;44;70;Leicht bewölkt;6;6;0
12.11.2020 23:00;62;30;32;Leicht bewölkt;6;6;0
13.11.2020 00:00;39;18;21;Leicht bewölkt;6;5;0
13.11.2020 01:00;26;11;15;Leicht bewölkt;5;5;0
13.11.2020 02:00;5;2;3;Leicht bewölkt;5;5;0
13.11.2020 03:00;5;2;3;Leicht bewölkt;5;5;0
13.11.2020 04:00;7;4;3;Leicht bewölkt;5;5;0
13.11.2020 05:00;33;24;9;Leicht bewölkt;5;5;0
13.11.2020 06:00;165;107;58;Leicht bewölkt;5;5;0
13.11.2020 07:00;883;602;281;Leicht bewölkt;6;6;0
13.11.2020 08:00;665;365;300;Leicht bewölkt;7;7;0
13.11.2020 09:00;536;335;201;Leicht bewölkt;8;8;0
13.11.2020 10:00;479;269;210;Leicht bewölkt;10;10;0
13.11.2020 11:00;609;297;312;Leicht bewölkt;11;11;0
13.11.2020 12:00;728;331;397;Leicht bewölkt;12;12;0
13.11.2020 13:00;981;366;615;Leicht bewölkt;12;12;0
13.11.2020 14:00;867;411;456;Leicht bewölkt;12;12;0
13.11.2020 15:00;885;414;471;Leicht bewölkt;12;12;0
13.11.2020 16:00;774;327;447;Leicht bewölkt;11;11;0
13.11.2020 17:00;681;278;403;Leicht bewölkt;10;10;0
13.11.2020 18:00;536;217;319;Leicht bewölkt;9;9;0
13.11.2020 19:00;357;159;198;Leicht bewölkt;8;8;0
13.11.2020 20:00;213;91;122;Leicht bewölkt;8;8;0
13.11.2020 21:00;136;59;77;Leicht bewölkt;7;7;0
13.11.2020 22:00;92;33;59;Leicht bewölkt;7;7;0
13.11.2020 23:00;91;40;51;Leicht bewölkt;7;7;0
14.11.2020 00:00;77;46;31;Leicht bewölkt;7;7;0
14.11.2020 01:00;67;33;34;Leicht bewölkt;6;6;0
14.11.2020 02:00;26;13;13;Leicht bewölkt;6;6;0
14.11.2020 03:00;15;5;10;Leicht bewölkt;6;6;0
14.11.2020 04:00;13;9;4;Leicht bewölkt;6;6;0
14.11.2020 05:00;19;13;6;Leicht bewölkt;5;5;0
14.11.2020 06:00;35;26;9;Leicht bewölkt;5;5;0
14.11.2020 07:00;70;39;31;Leicht bewölkt;6;6;0
14.11.2020 08:00;138;85;53;Leicht bewölkt;8;8;0
14.11.2020 09:00;296;188;108;Leicht bewölkt;9;9;0
14.11.2020 10:00;378;216;162;Leicht bewölkt;10;10;0
14.11.2020 11:00;432;225;207;Leicht bewölkt;12;12;0
14.11.2020 12:00;520;317;203;Leicht bewölkt;13;13;0
14.11.2020 13:00;552;295;257;Leicht bewölkt;13;13;0
14.11.2020 14:00;723;350;373;Leicht bewölkt;13;13;0
14.11.2020 15:00;668;288;380;Leicht bewölkt;13;13;0
14.11.2020 16:00;684;302;382;Leicht bewölkt;11;11;0
14.11.2020 17:00;573;228;345;Leicht bewölkt;10;10;0
14.11.2020 18:00;390;181;209;Leicht bewölkt;9;9;0
14.11.2020 19:00;234;110;124;Leicht bewölkt;8;8;0
14.11.2020 20:00;165;77;88;Leicht bewölkt;8;8;0
14.11.2020 21:00;100;41;59;Leicht bewölkt;7;7;0
14.11.2020 22:00;80;39;41;Leicht bewölkt;7;7;0
14.11.2020 23:00;90;40;50;Leicht bewölkt;7;7;0
15.11.2020 00:00;88;46;42;Leicht bewölkt;7;7;0
15.11.2020 01:00;43;24;19;Leicht bewölkt;6;6;0
15.11.2020 02:00;30;8;22;Leicht bewölkt;6;6;0
15.11.2020 03:00;22;12;10;Leicht bewölkt;6;6;0
15.11.2020 04:00;12;7;5;Leicht bewölkt;6;6;0
15.11.2020 05:00;13;8;5;Leicht bewölkt;5;5;0
15.11.2020 06:00;30;21;9;Leicht bewölkt;5;5;0
15.11.2020 07:00;21;11;10;Leicht bewölkt;6;6;0
15.11.2020 08:00;50;31;19;Leicht bewölkt;7;7;0
15.11.2020 09:00;106;66;40;Leicht bewölkt;8;8;0
15.11.2020 10:00;130;72;58;Leicht bewölkt;10;10;0
15.11.2020 11:00;195;106;89;Leicht bewölkt;11;11;0
15.11.2020 12:00;290;128;162;Leicht bewölkt;12;12;0
15.11.2020 13:00;395;176;219;Leicht bewölkt;12;12;0
15.11.2020 14:00;445;212;233;Bedeckt;12;12;0
15.11.2020 15:00;466;232;234;Bedeckt;11;11;0
15.11.2020 16:00;456;219;237;Bedeckt;10;10;0
15.11.2020 17:00;301;121;180;Leicht bewölkt;9;8;0
15.11.2020 18:00;182;93;89;Leicht bewölkt;8;7;0
15.11.2020 19:00;130;55;75;Leicht bewölkt;7;6;0
15.11.2020 20:00;111;54;57;Leicht bewölkt;7;6;0
15.11.2020 21:00;65;26;39;Leicht bewölkt;6;5;0
15.11.2020 22:00;63;33;30;Leicht bewölkt;7;5;0
15.11.2020 23:00;29;14;15;Bedeckt;7;6;0
16.11.2020 00:00;20;8;12;Bedeckt;8;6;0
16.11.2020 01:00;11;9;2;Bedeckt;8;6;0
16.11.2020 02:00;3;2;1;Leicht bewölkt;8;6;2
16.11.2020 03:00;3;1;2;Leicht bewölkt;9;6;3
16.11.2020 04:00;5;3;2;Leicht bewölkt;8;6;2
16.11.2020 05:00;35;18;17;Leichter Regenfall;8;5;1
16.11.2020 06:00;173;106;67;Leichter Regenfall;8;5;1
16.11.2020 07:00;939;605;334;Leichter Regenfall;8;5;1
16.11.2020 08:00;661;372;289;Bewölkt;8;5;0
16.11.2020 09:00;550;311;239;Bewölkt;8;6;0
16.11.2020 10:00;372;188;184;Bewölkt;9;7;0
16.11.2020 11:00;480;227;253;Stellenweiser Regenfall;9;7;0
16.11.2020 12:00;595;263;332;Stellenweiser Regenfall;10;8;0
16.11.2020 13:00;878;399;479;Stellenweiser Regenfall;10;8;0
16.11.2020 14:00;638;298;340;Stellenweiser Regenfall;10;8;0
16.11.2020 15:00;861;414;447;Stellenweiser Regenfall;9;8;0
16.11.2020 16:00;796;373;423;Stellenweiser Regenfall;9;7;0
16.11.2020 17:00;812;332;480;Stellenweiser Regenfall;8;7;0
16.11.2020 18:00;515;211;304;Stellenweiser Regenfall;7;6;0
16.11.2020 19:00;305;143;162;Stellenweiser Regenfall;6;5;0
16.11.2020 20:00;194;75;119;Bewölkt;5;4;0
16.11.2020 21:00;138;69;69;Bewölkt;4;4;0
16.11.2020 22:00;68;27;41;Bewölkt;4;4;0
16.11.2020 23:00;46;16;30;Leichter Regenschauer;5;4;1
17.11.2020 00:00;25;14;11;Leichter Regenschauer;5;5;1
17.11.2020 01:00;16;9;7;Leichter Regenschauer;5;4;0
17.11.2020 02:00;5;4;1;Stellenweiser Regenfall;4;4;0
17.11.2020 03:00;2;2;0;Stellenweiser Regenfall;4;4;0
17.11.2020 04:00;8;5;3;Stellenweiser Regenfall;4;4;0
17.11.2020 05:00;49;26;23;Bewölkt;4;4;0
17.11.2020 06:00;190;111;79;Bewölkt;3;3;0
17.11.2020 07:00;952;605;347;Bewölkt;4;4;0
17.11.2020 08:00;760;426;334;Leicht bewölkt;5;5;0
17.11.2020 09:00;594;361;233;Leicht bewölkt;6;6;0
17.11.2020 10:00;468;257;211;Leicht bewölkt;7;7;0
17.11.2020 11:00;540;257;283;Leicht bewölkt;8;8;0
17.11.2020 12:00;690;295;395;Leicht bewölkt;9;9;0
17.11.2020 13:00;907;374;533;Leicht bewölkt;9;9;0
17.11.2020 14:00;740;382;358;Leicht bewölkt;9;9;0
17.11.2020 15:00;997;486;511;Leicht bewölkt;9;9;0
17.11.2020 16:00;956;419;537;Leicht bewölkt;8;8;0
17.11.2020 17:00;852;335;517;Leicht bewölkt;7;7;0
17.11.2020 18:00;566;239;327;Leicht bewölkt;7;7;0
17.11.2020 19:00;352;151;201;Leicht bewölkt;6;6;0
17.11.2020 20:00;231;101;130;Leicht bewölkt;5;5;0
17.11.2020 21:00;127;58;69;Leicht bewölkt;5;5;0
17.11.2020 22:00;71;34;37;Leicht bewölkt;5;5;0
17.11.2020 23:00;67;35;32;Leicht bewölkt;5;5;0
18.11.2020 00:00;26;14;12;Leicht bewölkt;5;5;0
18.11.2020 01:00;14;11;3;Leicht bewölkt;5;5;0
18.11.2020 02:00;6;2;4;Leicht bewölkt;4;4;0
18.11.2020 03:00;3;1;2;Leicht bewölkt;4;4;0
18.11.2020 04:00;11;11;0;Leicht bewölkt;4;4;0
18.11.2020 05:00;40;25;15;Leicht bewölkt;4;4;0
18.11.2020 06:00;180;111;69;Leicht bewölkt;4;4;0
18.11.2020 07:00;944;595;349;Leicht bewölkt;5;5;0
18.11.2020 08:00;709;398;311;Leicht bewölkt;6;6;0
18.11.2020 09:00;500;307;193;Leicht bewölkt;7;7;0
18.11.2020 10:00;346;187;159;Leicht bewölkt;9;9;0
18.11.2020 11:00;498;234;264;Leicht bewölkt;10;10;0
18.11.2020 12:00;609;280;329;Leicht bewölkt;12;12;0
18.11.2020 13:00;960;435;525;Leicht bewölkt;12;12;0
18.11.2020 14:00;675;341;334;Sonnig;11;11;0
18.11.2020 15:00;837;391;446;Sonnig;11;11;0
18.11.2020 16:00;816;373;443;Sonnig;10;10;0
18.11.2020 17:00;834;339;495;Leicht bewölkt;9;9;0
18.11.2020 18:00;610;260;350;Leicht bewölkt;7;7;0
18.11.2020 19:00;312;132;180;Leicht bewölkt;7;7;0
18.11.2020 20:00;215;88;127;Leicht bewölkt;6;6;0
18.11.2020 21:00;118;50;68;Leicht bewölkt;6;6;0
18.11.2020 22:00;109;55;54;Leicht bewölkt;5;5;0
18.11.2020 23:00;51;21;30;Leicht bewölkt;5;5;0
19.11.2020 00:00;29;15;14;Leicht bewölkt;5;4;0
19.11.2020 01:00;16;7;9;Leicht bewölkt;5;5;0
19.11.2020 02:00;10;4;6;Leicht bewölkt;5;5;0
19.11.2020 03:00;5;3;2;Leicht bewölkt;6;5;0
19.11.2020 04:00;5;3;2;Leicht bewölkt;5;5;0
19.11.2020 05:00;41;23;18;Leicht bewölkt;5;4;0
19.11.2020 06:00;182;100;82;Leicht bewölkt;5;4;0
19.11.2020 07:00;925;598;327;Leicht bewölkt;6;5;0
19.11.2020 08:00;628;360;268;Bewölkt;7;6;0
19.11.2020 09:00;486;276;210;Bewölkt;8;7;0
19.11.2020 10:00;310;163;147;Bewölkt;9;8;0
19.11.2020 11:00;359;179;180;Stellenweiser Regenfall;9;8;2
19.11.2020 12:00;493;218;275;Stellenweiser Regenfall;10;8;3
19.11.2020 13:00;604;240;364;Stellenweiser Regenfall;9;7;1
19.11.2020 14:00;462;198;264;Leichter Regenfall;9;6;2
19.11.2020 15:00;637;327;310;Leichter Regenfall;8;5;3
19.11.2020 16:00;639;331;308;Leichter Regenfall;8;5;1
19.11.2020 17:00;637;279;358;Stellenweiser Regenfall;7;4;2
19.11.2020 18:00;599;257;342;Stellenweiser Regenfall;7;3;2
19.11.2020 19:00;329;141;188;Stellenweiser Regenfall;6;3;1
19.11.2020 20:00;201;77;124;Nieselregen;6;3;1
19.11.2020 21:00;117;44;73;Nieselregen;6;3;1
19.11.2020 22:00;101;51;50;Nieselregen;6;3;1
19.11.2020 23:00;54;19;35;Leichter Regenschauer;5;3;2
20.11.2020 00:00;29;12;17;Leichter Regenschauer;5;3;3
20.11.2020 01:00;21;16;5;Leichter Regenschauer;5;3;2
20.11.2020 02:00;5;2;3;Leichter Regenschauer;5;3;1
20.11.2020 03:00;8;3;5;Leichter Regenschauer;5;3;2
20.11.2020 04:00;8;6;2;Leichter Regenschauer;4;2;1
20.11.2020 05:00;35;21;14;Leichter Regenschauer;4;2;4
20.11.2020 06:00;159;93;66;Leichter Regenschauer;3;1;6
20.11.2020 07:00;818;552;266;Leichter Regenschauer;3;0;3
20.11.2020 08:00;645;339;306;Stellenweise starker Schneefall;3;0;4
20.11.2020 09:00;568;337;231;Stellenweise starker Schneefall;3;-1;5
20.11.2020 10:00;472;272;200;Stellenweise starker Schneefall;3;0;2
20.11.2020 11:00;543;260;283;Stellenweise starker Schneefall;3;0;1
20.11.2020 12:00;750;328;422;Stellenweise starker Schneefall;4;1;1
20.11.2020 13:00;973;374;599;Stellenweise starker Schneefall;4;1;1
20.11.2020 14:00;763;362;401;Stellenweiser Regenfall;4;1;0
20.11.2020 15:00;681;319;362;Stellenweiser Regenfall;4;2;0
20.11.2020 16:00;682;305;377;Stellenweiser Regenfall;3;0;0
20.11.2020 17:00;581;251;330;Leicht bewölkt;2;-1;0
20.11.2020 18:00;511;221;290;Leicht bewölkt;1;-2;0
20.11.2020 19:00;334;153;181;Leicht bewölkt;0;-3;0
20.11.2020 20:00;183;74;109;Sonnig;0;-3;0
20.11.2020 21:00;110;51;59;Sonnig;-1;-3;0
20.11.2020 22:00;78;39;39;Sonnig;0;-3;0
20.11.2020 23:00;107;42;65;Sonnig;0;-3;0
21.11.2020 00:00;71;30;41;Sonnig;0;-2;0
21.11.2020 01:00;45;27;18;Sonnig;0;-2;0
21.11.2020 02:00;16;12;4;Sonnig;0;-1;0
21.11.2020 03:00;14;6;8;Sonnig;0;-1;0
21.11.2020 04:00;19;12;7;Sonnig;0;-1;0
21.11.2020 05:00;21;10;11;Sonnig;-1;-1;0
21.11.2020 06:00;39;24;15;Sonnig;-1;-1;0
21.11.2020 07:00;67;38;29;Sonnig;0;-1;0
21.11.2020 08:00;137;91;46;Leicht bewölkt;1;0;0
21.11.2020 09:00;292;179;113;Leicht bewölkt;1;1;0
21.11.2020 10:00;434;256;178;Leicht bewölkt;3;2;0
21.11.2020 11:00;523;271;252;Leicht bewölkt;4;4;0
21.11.2020 12:00;522;256;266;Leicht bewölkt;5;5;0
21.11.2020 13:00;575;291;284;Leicht bewölkt;5;5;0
21.11.2020 14:00;692;309;383;Leicht bewölkt;5;5;0
21.11.2020 15:00;601;309;292;Leicht bewölkt;5;5;0
21.11.2020 16:00;494;209;285;Leicht bewölkt;4;4;0
21.11.2020 17:00;450;171;279;Leicht bewölkt;3;3;0
21.11.2020 18:00;342;121;221;Leicht bewölkt;2;2;0
21.11.2020 19:00;245;110;135;Leicht bewölkt;1;1;0
21.11.2020 20:00;174;71;103;Leicht bewölkt;1;1;0
21.11.2020 21:00;78;40;38;Leicht bewölkt;1;1;0
21.11.2020 22:00;85;41;44;Leicht bewölkt;1;1;0
21.11.2020 23:00;76;46;30;Leicht bewölkt;1;1;0
22.11.2020 00:00;109;58;51;Leicht bewölkt;1;1;0
22.11.2020 01:00;47;26;21;Leicht bewölkt;1;1;0
22.11.2020 02:00;37;16;21;Leicht bewölkt;0;0;0
22.11.2020 03:00;32;18;14;Leicht bewölkt;0;0;0
22.11.2020 04:00;12;6;6;Leicht bewölkt;0;0;0
22.11.2020 05:00;8;3;5;Leicht bewölkt;-1;-1;0
22.11.2020 06:00;17;12;5;Leicht bewölkt;-1;-1;0
22.11.2020 07:00;20;14;6;Leicht bewölkt;0;0;0
22.11.2020 08:00;36;21;15;Leicht bewölkt;1;1;0
22.11.2020 09:00;90;51;39;Leicht bewölkt;2;2;0
22.11.2020 10:00;139;68;71;Leicht bewölkt;3;3;0
22.11.2020 11:00;162;96;66;Leicht bewölkt;5;5;0
22.11.2020 12:00;245;118;127;Leicht bewölkt;6;6;0
22.11.2020 13:00;258;121;137;Leicht bewölkt;6;6;0
22.11.2020 14:00;397;183;214;Leicht bewölkt;5;5;0
22.11.2020 15:00;359;170;189;Leicht bewölkt;5;5;0
22.11.2020 16:00;317;177;140;Leicht bewölkt;4;4;0
22.11.2020 17:00;226;105;121;Leicht bewölkt;3;3;0
22.11.2020 18:00;195;99;96;Leicht bewölkt;2;2;0
22.11.2020 19:00;134;62;72;Leicht bewölkt;1;1;0
22.11.2020 20:00;84;36;48;Leicht bewölkt;1;1;0
22.11.2020 21:00;55;21;34;Leicht bewölkt;1;1;0
22.11.2020 22:00;59;31;28;Leicht bewölkt;0;0;0
22.11.2020 23:00;49;20;29;Leicht bewölkt;0;0;0
23.11.2020 00:00;24;8;16;Leicht bewölkt;0;0;0
23.11.2020 01:00;2;0;2;Leicht bewölkt;0;0;0
23.11.2020 02:00;5;4;1;Bewölkt;0;0;0
23.11.2020 03:00;3;2;1;Bewölkt;0;0;0
23.11.2020 04:00;7;4;3;Bewölkt;0;0;0
23.11.2020 05:00;40;23;17;Bedeckt;-1;-1;0
23.11.2020 06:00;161;98;63;Bedeckt;-1;-1;0
23.11.2020 07:00;956;623;333;Bedeckt;0;0;0
23.11.2020 08:00;662;376;286;Bedeckt;1;1;0
23.11.2020 09:00;492;275;217;Bedeckt;2;2;0
23.11.2020 10:00;366;199;167;Bedeckt;4;4;0
23.11.2020 11:00;471;213;258;Bedeckt;5;5;0
23.11.2020 12:00;602;264;338;Bedeckt;6;6;0
23.11.2020 13:00;883;345;538;Bedeckt;6;6;0
23.11.2020 14:00;684;344;340;Leicht bewölkt;6;6;0
23.11.2020 15:00;827;384;443;Leicht bewölkt;5;5;0
23.11.2020 16:00;832;388;444;Leicht bewölkt;5;5;0
23.11.2020 17:00;760;318;442;Leicht bewölkt;4;4;0
23.11.2020 18:00;547;218;329;Leicht bewölkt;3;3;0
23.11.2020 19:00;303;136;167;Leicht bewölkt;3;3;0
23.11.2020 20:00;207;89;118;Leicht bewölkt;2;2;0
23.11.2020 21:00;126;55;71;Leicht bewölkt;2;2;0
23.11.2020 22:00;86;44;42;Leicht bewölkt;2;2;0
23.11.2020 23:00;44;19;25;Leicht bewölkt;2;2;0
24.11.2020 00:00;27;9;18;Leicht bewölkt;2;2;0
24.11.2020 01:00;13;9;4;Leicht bewölkt;2;2;0
24.11.2020 02:00;8;6;2;Leicht bewölkt;2;1;0
24.11.2020 03:00;6;4;2;Leicht bewölkt;2;1;0
24.11.2020 04:00;6;5;1;Leicht bewölkt;1;1;0
24.11.2020 05:00;52;34;18;Leicht bewölkt;1;0;0
24.11.2020 06:00;178;106;72;Leicht bewölkt;1;0;0
24.11.2020 07:00;921;604;317;Leicht bewölkt;2;1;0
24.11.2020 08:00;745;393;352;Leicht bewölkt;3;2;0
24.11.2020 09:00;529;337;192;Leicht bewölkt;3;3;0
24.11.2020 10:00;391;205;186;Leicht bewölkt;5;4;0
24.11.2020 11:00;485;252;233;Sonnig;6;6;0
24.11.2020 12:00;574;266;308;Sonnig;8;8;0
24.11.2020 13:00;783;293;490;Sonnig;8;8;0
24.11.2020 14:00;622;274;348;Sonnig;8;8;0
24.11.2020 15:00;869;452;417;Sonnig;8;8;0
24.11.2020 16:00;778;388;390;Sonnig;7;7;0
24.11.2020 17:00;834;335;499;Sonnig;6;6;0
24.11.2020 18:00;607;273;334;Sonnig;5;5;0
24.11.2020 19:00;320;128;192;Sonnig;4;4;0
24.11.2020 20:00;220;101;119;Sonnig;4;4;0
24.11.2020 21:00;106;40;66;Sonnig;3;3;0
24.11.2020 22:00;76;32;44;Sonnig;3;3;0
24.11.2020 23:00;69;38;31;Sonnig;3;3;0
25.11.2020 00:00;36;18;18;Sonnig;2;2;0
25.11.2020 01:00;15;9;6;Sonnig;2;2;0
25.11.2020 02:00;7;5;2;Sonnig;2;2;0
25.11.2020 03:00;4;3;1;Sonnig;2;2;0
25.11.2020 04:00;10;8;2;Sonnig;2;2;0
25.11.2020 05:00;50;32;18;Sonnig;2;2;0
25.11.2020 06:00;156;95;61;Sonnig;2;2;0
25.11.2020 07:00;919;599;320;Sonnig;3;3;0
25.11.2020 08:00;657;358;299;Sonnig;4;4;0
25.11.2020 09:00;496;305;191;Sonnig;5;5;0
25.11.2020 10:00;370;202;168;Sonnig;6;6;0
25.11.2020 11:00;432;214;218;Sonnig;8;8;0
25.11.2020 12:00;546;266;280;Sonnig;9;9;0
25.11.2020 13:00;889;392;497;Sonnig;8;8;0
25.11.2020 14:00;620;291;329;Leicht bewölkt;8;8;0
25.11.2020 15:00;750;323;427;Leicht bewölkt;7;7;0
25.11.2020 16:00;701;340;361;Leicht bewölkt;6;6;0
25.11.2020 17:00;674;295;379;Leicht bewölkt;6;6;0
25.11.2020 18:00;518;219;299;Leicht bewölkt;5;5;0
25.11.2020 19:00;296;126;170;Leicht bewölkt;5;5;0
25.11.2020 20:00;238;102;136;Leicht bewölkt;4;4;0
25.11.2020 21:00;102;48;54;Leicht bewölkt;4;4;0
25.11.2020 22:00;85;41;44;Leicht bewölkt;3;3;0
25.11.2020 23:00;73;33;40;Leicht bewölkt;2;2;0
26.11.2020 00:00;28;13;15;Leicht bewölkt;1;1;0
26.11.2020 01:00;19;6;13;Leicht bewölkt;1;1;0
26.11.2020 02:00;5;1;4;Leicht bewölkt;1;1;0
26.11.2020 03:00;6;3;3;Leicht bewölkt;1;1;0
26.11.2020 04:00;6;5;1;Leicht bewölkt;1;1;0
26.11.2020 05:00;51;34;17;Leicht bewölkt;0;0;0
26.11.2020 06:00;154;90;64;Leicht bewölkt;0;0;0
26.11.2020 07:00;959;639;320;Leicht bewölkt;1;1;0
26.11.2020 08:00;712;388;324;Leicht bewölkt;2;2;0
26.11.2020 09:00;490;281;209;Leicht bewölkt;4;4;0
26.11.2020 10:00;378;201;177;Leicht bewölkt;5;5;0
26.11.2020 11:00;432;220;212;Leicht bewölkt;7;7;0
26.11.2020 12:00;551;237;314;Leicht bewölkt;8;8;0
26.11.2020 13:00;765;339;426;Leicht bewölkt;7;7;0
26.11.2020 14:00;672;307;365;Leicht bewölkt;7;7;0
26.11.2020 15:00;812;372;440;Leicht bewölkt;6;6;0
26.11.2020 16:00;777;384;393;Leicht bewölkt;5;5;0
26.11.2020 17:00;787;350;437;Leicht bewölkt;4;4;0
26.11.2020 18:00;623;268;355;Leicht bewölkt;3;3;0
26.11.2020 19:00;356;141;215;Leicht bewölkt;2;2;0
26.11.2020 20:00;234;110;124;Leicht bewölkt;2;2;0
26.11.2020 21:00;147;58;89;Leicht bewölkt;2;2;0
26.11.2020 22:00;90;43;47;Leicht bewölkt;1;1;0
26.11.2020 23:00;69;29;40;Leicht bewölkt;1;1;0
27.11.2020 00:00;35;15;20;Leicht bewölkt;0;0;0
27.11.2020 01:00;22;12;10;Leicht bewölkt;1;1;0
27.11.2020 02:00;17;11;6;Leicht bewölkt;1;1;0
27.11.2020 03:00;4;0;4;Leicht bewölkt;1;1;0
27.11.2020 04:00;10;5;5;Leicht bewölkt;1;1;0
27.11.2020 05:00;32;21;11;Leicht bewölkt;0;0;0
27.11.2020 06:00;158;94;64;Leicht bewölkt;0;0;0
27.11.2020 07:00;868;579;289;Leicht bewölkt;1;1;0
27.11.2020 08:00;642;372;270;Leicht bewölkt;3;3;0
27.11.2020 09:00;565;313;252;Leicht bewölkt;4;4;0
27.11.2020 10:00;457;260;197;Leicht bewölkt;5;5;0
27.11.2020 11:00;565;294;271;Leicht bewölkt;7;7;0
27.11.2020 12:00;722;308;414;Leicht bewölkt;9;9;0
27.11.2020 13:00;906;353;553;Leicht bewölkt;9;9;0
27.11.2020 14:00;733;364;369;Leicht bewölkt;8;8;0
27.11.2020 15:00;696;337;359;Leicht bewölkt;8;8;0
27.11.2020 16:00;689;309;380;Leicht bewölkt;7;7;0
27.11.2020 17:00;608;267;341;Leicht bewölkt;6;6;0
27.11.2020 18:00;523;228;295;Leicht bewölkt;5;5;0
27.11.2020 19:00;340;138;202;Leicht bewölkt;4;4;0
27.11.2020 20:00;213;84;129;Sonnig;4;3;0
27.11.2020 21:00;120;47;73;Sonnig;3;2;0
27.11.2020 22:00;74;32;42;Sonnig;2;2;0
27.11.2020 23:00;90;45;45;Leicht bewölkt;2;1;0
28.11.2020 00:00;61;34;27;Leicht bewölkt;2;1;0
28.11.2020 01:00;34;15;19;Leicht bewölkt;2;1;0
28.11.2020 02:00;26;12;14;Leicht bewölkt;2;1;0
28.11.2020 03:00;14;10;4;Leicht bewölkt;2;1;0
28.11.2020 04:00;12;7;5;Leicht bewölkt;1;0;0
28.11.2020 05:00;28;17;11;Sonnig;1;-1;0
28.11.2020 06:00;35;18;17;Sonnig;0;-1;0
28.11.2020 07:00;73;39;34;Sonnig;1;0;0
28.11.2020 08:00;142;69;73;Leicht bewölkt;2;0;0
28.11.2020 09:00;264;176;88;Leicht bewölkt;3;1;0
28.11.2020 10:00;382;231;151;Leicht bewölkt;4;3;0
28.11.2020 11:00;413;219;194;Leicht bewölkt;5;4;0
28.11.2020 12:00;471;245;226;Leicht bewölkt;7;5;0
28.11.2020 13:00;487;246;241;Leicht bewölkt;6;5;0
28.11.2020 14:00;454;214;240;Sonnig;6;4;0
28.11.2020 15:00;503;249;254;Sonnig;5;3;0
28.11.2020 16:00;450;193;257;Sonnig;4;2;0
28.11.2020 17:00;401;158;243;Leicht bewölkt;3;1;0
28.11.2020 18:00;293;121;172;Leicht bewölkt;2;-1;0
28.11.2020 19:00;266;111;155;Leicht bewölkt;2;-1;0
28.11.2020 20:00;181;77;104;Leicht bewölkt;1;-2;0
28.11.2020 21:00;109;36;73;Leicht bewölkt;1;-2;0
28.11.2020 22:00;72;36;36;Leicht bewölkt;1;-2;0
28.11.2020 23:00;77;44;33;Leicht bewölkt;0;-3;0
29.11.2020 00:00;73;34;39;Leicht bewölkt;0;-3;0
29.11.2020 01:00;60;28;32;Leicht bewölkt;0;-3;0
29.11.2020 02:00;35;16;19;Leicht bewölkt;0;-4;0
29.11.2020 03:00;17;10;7;Leicht bewölkt;-1;-4;0
29.11.2020 04:00;20;14;6;Leicht bewölkt;-1;-4;0
29.11.2020 05:00;22;16;6;Bewölkt;-1;-4;0
29.11.2020 06:00;22;14;8;Bewölkt;-1;-4;0
29.11.2020 07:00;27;12;15;Bewölkt;0;-4;0
29.11.2020 08:00;32;18;14;Bewölkt;0;-4;0
29.11.2020 09:00;77;48;29;Bewölkt;1;-3;0
29.11.2020 10:00;98;51;47;Bewölkt;1;-3;0
29.11.2020 11:00;150;73;77;Bedeckt;1;-2;0
29.11.2020 12:00;164;68;96;Bedeckt;2;-2;0
29.11.2020 13:00;230;105;125;Bedeckt;2;-1;0
29.11.2020 14:00;254;124;130;Bedeckt;2;-1;0
29.11.2020 15:00;278;120;158;Bedeckt;2;-1;0
29.11.2020 16:00;232;123;109;Bedeckt;1;-2;0
29.11.2020 17:00;197;101;96;Leicht bewölkt;0;-2;0
29.11.2020 18:00;196;97;99;Leicht bewölkt;0;-3;0
29.11.2020 19:00;110;54;56;Leicht bewölkt;-1;-4;0
29.11.2020 20:00;93;38;55;Leicht bewölkt;-1;-4;0
29.11.2020 21:00;64;25;39;Leicht bewölkt;-2;-5;0
29.11.2020 22:00;67;33;34;Leicht bewölkt;-2;-5;0
29.11.2020 23:00;36;18;18;Leicht bewölkt;-3;-5;0
30.11.2020 00:00;21;9;12;Leicht bewölkt;-3;-6;0
30.11.2020 01:00;5;2;3;Leicht bewölkt;-3;-6;0
30.11.2020 02:00;3;3;0;Leicht bewölkt;-3;-6;0
30.11.2020 03:00;5;2;3;Leicht bewölkt;-4;-6;0
30.11.2020 04:00;8;7;1;Leicht bewölkt;-4;-6;0
30.11.2020 05:00;50;29;21;Leicht bewölkt;-4;-6;0
30.11.2020 06:00;156;87;69;Leicht bewölkt;-4;-6;0
30.11.2020 07:00;872;571;301;Leicht bewölkt;-3;-5;0
30.11.2020 08:00;615;328;287;Leicht bewölkt;-2;-4;0
30.11.2020 09:00;560;328;232;Leicht bewölkt;-2;-3;0
30.11.2020 10:00;399;200;199;Leicht bewölkt;0;-1;0
30.11.2020 11:00;442;206;236;Bewölkt;1;0;0
30.11.2020 12:00;553;249;304;Bewölkt;2;2;0
30.11.2020 13:00;769;325;444;Bewölkt;2;2;0
30.11.2020 14:00;644;318;326;Leicht bewölkt;2;2;0
30.11.2020 15:00;821;374;447;Leicht bewölkt;3;3;0
30.11.2020 16:00;748;357;391;Leicht bewölkt;2;2;0
30.11.2020 17:00;744;329;415;Sonnig;1;1;0
30.11.2020 18:00;506;201;305;Sonnig;1;1;0
30.11.2020 19:00;322;117;205;Sonnig;0;0;0
30.11.2020 20:00;188;85;103;Leicht bewölkt;-1;-2;0
30.11.2020 21:00;115;46;69;Leicht bewölkt;-2;-3;0
30.11.2020 22:00;75;36;39;Leicht bewölkt;-2;-3;0
30.11.2020 23:00;50;25;25;Sonnig;-2;-3;0
01.12.2020 00:00;21;13;8;Sonnig;-2;-3;0
01.12.2020 01:00;13;6;7;Sonnig;-2;-3;0
01.12.2020 02:00;3;2;1;Leicht bewölkt;-2;-3;0
01.12.2020 03:00;3;0;3;Leicht bewölkt;-2;-3;0
01.12.2020 04:00;10;7;3;Leicht bewölkt;-1;-3;0
01.12.2020 05:00;32;18;14;Bedeckt;0;-3;0
01.12.2020 06:00;143;88;55;Bedeckt;1;-2;0
01.12.2020 07:00;585;358;227;Bedeckt;1;-2;0
01.12.2020 08:00;439;236;203;Bedeckt;1;-2;4
01.12.2020 09:00;351;214;137;Bedeckt;2;-1;5
01.12.2020 10:00;231;137;94;Bedeckt;2;-1;2
01.12.2020 11:00;302;142;160;Leichter Eisregen;2;-1;6
01.12.2020 12:00;331;149;182;Leichter Eisregen;2;-1;8
01.12.2020 13:00;500;226;274;Leichter Eisregen;2;-1;4
01.12.2020 14:00;412;197;215;Leichter Eisregen;2;-1;5
01.12.2020 15:00;574;274;300;Leichter Eisregen;2;0;6
01.12.2020 16:00;482;235;247;Leichter Eisregen;1;-1;3
01.12.2020 17:00;538;248;290;Leichter Eisregen;0;-1;4
01.12.2020 18:00;467;214;253;Leichter Eisregen;-1;-2;5
01.12.2020 19:00;265;104;161;Leichter Eisregen;-3;-3;2
01.12.2020 20:00;155;59;96;Starker Schneefall;-4;-4;2
01.12.2020 21:00;101;32;69;Starker Schneefall;-6;-6;2
01.12.2020 22:00;68;33;35;Starker Schneefall;-3;-4;1
01.12.2020 23:00;55;24;31;Starker Schneefall;-1;-2;4
02.12.2020 00:00;24;14;10;Starker Schneefall;1;-1;6
02.12.2020 01:00;14;5;9;Starker Schneefall;1;-1;3
02.12.2020 02:00;5;0;5;Starker Schneefall;1;-2;2
02.12.2020 03:00;4;2;2;Starker Schneefall;1;-2;2
02.12.2020 04:00;5;4;1;Starker Schneefall;1;-2;1
02.12.2020 05:00;47;33;14;Mäßiger Schneefall;0;-2;0
02.12.2020 06:00;149;78;71;Mäßiger Schneefall;0;-3;0
02.12.2020 07:00;796;501;295;Mäßiger Schneefall;0;-3;0
02.12.2020 08:00;637;358;279;Mäßiger Schneefall;0;-3;0
02.12.2020 09:00;504;331;173;Mäßiger Schneefall;0;-3;0
02.12.2020 10:00;368;192;176;Mäßiger Schneefall;1;-2;0
02.12.2020 11:00;426;206;220;Stellenweise leichter Schneefall;1;-2;0
02.12.2020 12:00;548;254;294;Stellenweise leichter Schneefall;1;-1;0
02.12.2020 13:00;856;390;466;Stellenweise leichter Schneefall;1;-2;0
02.12.2020 14:00;581;289;292;Stellenweise leichter Schneefall;1;-2;0
02.12.2020 15:00;722;286;436;Stellenweise leichter Schneefall;1;-2;0
02.12.2020 16:00;664;331;333;Stellenweise leichter Schneefall;0;-2;0
02.12.2020 17:00;628;278;350;Leichter Schneefall;0;-2;0
02.12.2020 18:00;499;194;305;Leichter Schneefall;-1;-3;0
02.12.2020 19:00;328;134;194;Leichter Schneefall;-1;-2;0
02.12.2020 20:00;190;73;117;Mäßiger Schneefall;-1;-2;0
02.12.2020 21:00;114;51;63;Mäßiger Schneefall;-1;-2;0
02.12.2020 22:00;75;45;30;Mäßiger Schneefall;-2;-2;0
02.12.2020 23:00;51;20;31;Stellenweise leichter Schneefall;-2;-3;0
03.12.2020 00:00;26;14;12;Stellenweise leichter Schneefall;-2;-3;0
03.12.2020 01:00;18;11;7;Stellenweise leichter Schneefall;-2;-3;0
03.12.2020 02:00;13;12;1;Leicht bewölkt;-3;-3;0
03.12.2020 03:00;2;0;2;Leicht bewölkt;-3;-3;0
03.12.2020 04:00;5;4;1;Leicht bewölkt;-3;-4;0
03.12.2020 05:00;39;23;16;Leicht bewölkt;-4;-4;0
03.12.2020 06:00;173;104;69;Leicht bewölkt;-4;-5;0
03.12.2020 07:00;841;532;309;Leicht bewölkt;-3;-4;0
03.12.2020 08:00;618;326;292;Bedeckt;-2;-3;0
03.12.2020 09:00;491;280;211;Bedeckt;-2;-2;0
03.12.2020 10:00;367;206;161;Bedeckt;-1;-1;0
03.12.2020 11:00;433;216;217;Leicht bewölkt;0;0;0
03.12.2020 12:00;515;235;280;Leicht bewölkt;1;0;0
03.12.2020 13:00;736;312;424;Leicht bewölkt;1;1;0
03.12.2020 14:00;664;322;342;Leicht bewölkt;1;1;0
03.12.2020 15:00;871;443;428;Leicht bewölkt;2;1;0
03.12.2020 16:00;742;366;376;Leicht bewölkt;1;0;0
03.12.2020 17:00;753;313;440;Leicht bewölkt;0;0;0
03.12.2020 18:00;538;227;311;Leicht bewölkt;-1;-1;0
03.12.2020 19:00;341;135;206;Leicht bewölkt;-2;-2;0
03.12.2020 20:00;184;70;114;Leicht bewölkt;-2;-2;0
03.12.2020 21:00;132;53;79;Leicht bewölkt;-3;-3;0
03.12.2020 22:00;96;41;55;Leicht bewölkt;-2;-2;0
03.12.2020 23:00;53;18;35;Bedeckt;-2;-2;0
04.12.2020 00:00;33;18;15;Bedeckt;-2;-2;0
04.12.2020 01:00;20;13;7;Bedeckt;-1;-1;0
04.12.2020 02:00;10;6;4;Bedeckt;0;-1;0
04.12.2020 03:00;5;1;4;Bedeckt;1;0;0
04.12.2020 04:00;10;8;2;Bedeckt;1;0;0
04.12.2020 05:00;32;19;13;Bedeckt;1;-1;0
04.12.2020 06:00;143;80;63;Bedeckt;1;-1;0
04.12.2020 07:00;786;515;271;Bedeckt;1;0;0
04.12.2020 08:00;607;316;291;Bedeckt;2;0;0
04.12.2020 09:00;530;326;204;Bedeckt;3;1;0
04.12.2020 10:00;442;259;183;Bedeckt;4;2;0
04.12.2020 11:00;524;267;257;Leicht bewölkt;5;2;0
04.12.2020 12:00;668;304;364;Leicht bewölkt;5;3;0
04.12.2020 13:00;855;341;514;Leicht bewölkt;5;3;0
04.12.2020 14:00;673;301;372;Leicht bewölkt;4;3;0
04.12.2020 15:00;649;327;322;Leicht bewölkt;3;2;0
04.12.2020 16:00;597;272;325;Leicht bewölkt;2;2;0
04.12.2020 17:00;540;242;298;Bedeckt;1;1;0
04.12.2020 18:00;482;182;300;Bedeckt;0;0;0
04.12.2020 19:00;344;144;200;Bedeckt;0;0;0
04.12.2020 20:00;214;80;134;Leicht bewölkt;-1;-1;0
04.12.2020 21:00;114;51;63;Leicht bewölkt;-1;-1;0
04.12.2020 22:00;92;36;56;Leicht bewölkt;-1;-2;0
04.12.2020 23:00;88;39;49;Leichter Schneefall;-1;-2;1
05.12.2020 00:00;60;27;33;Leichter Schneefall;-1;-2;2
05.12.2020 01:00;54;25;29;Leichter Schneefall;-1;-2;1
05.12.2020 02:00;36;25;11;Mäßiger bis starker gefrierender Regen;-1;-1;2
05.12.2020 03:00;22;8;14;Mäßiger bis starker gefrierender Regen;-1;-1;2
05.12.2020 04:00;11;4;7;Mäßiger bis starker gefrierender Regen;-1;-1;1
05.12.2020 05:00;16;9;7;Starker Schneefall;-1;-1;6
05.12.2020 06:00;33;16;17;Starker Schneefall;-1;-1;8
05.12.2020 07:00;44;19;25;Starker Schneefall;0;0;4
05.12.2020 08:00;93;57;36;Starker Schneefall;1;1;5
05.12.2020 09:00;237;140;97;Starker Schneefall;1;1;7
05.12.2020 10:00;309;177;132;Starker Schneefall;1;1;3
05.12.2020 11:00;404;209;195;Starker Schneefall;2;2;6
05.12.2020 12:00;452;243;209;Starker Schneefall;2;2;8
05.12.2020 13:00;411;211;200;Starker Schneefall;2;2;4
05.12.2020 14:00;466;221;245;Starker Schneefall;2;2;4
05.12.2020 15:00;425;213;212;Starker Schneefall;2;2;5
05.12.2020 16:00;346;147;199;Starker Schneefall;2;1;2
05.12.2020 17:00;315;130;185;Starker Schneefall;2;1;1
05.12.2020 18:00;233;110;123;Starker Schneefall;1;0;1
05.12.2020 19:00;197;62;135;Starker Schneefall;1;0;0
05.12.2020 20:00;128;64;64;Nebel;1;-1;1
05.12.2020 21:00;79;34;45;Nebel;1;-1;1
05.12.2020 22:00;68;30;38;Nebel;0;-2;0
05.12.2020 23:00;62;31;31;Leichter Schneefall;0;-2;9
06.12.2020 00:00;58;27;31;Leichter Schneefall;-1;-3;12
06.12.2020 01:00;52;29;23;Leichter Schneefall;0;-2;6
06.12.2020 02:00;20;11;9;Starker Schneefall;0;-2;11
06.12.2020 03:00;10;5;5;Starker Schneefall;1;-1;15
06.12.2020 04:00;8;5;3;Starker Schneefall;1;-1;8
06.12.2020 05:00;9;5;4;Starker Schneefall;1;0;14
06.12.2020 06:00;16;8;8;Starker Schneefall;1;1;18
06.12.2020 07:00;18;12;6;Starker Schneefall;1;1;9
06.12.2020 08:00;35;16;19;Starker Schneefall;2;1;6
06.12.2020 09:00;47;33;14;Starker Schneefall;2;2;8
06.12.2020 10:00;67;43;24;Starker Schneefall;2;2;4
06.12.2020 11:00;125;52;73;Starker Schneefall;2;2;4
06.12.2020 12:00;127;59;68;Starker Schneefall;3;3;5
06.12.2020 13:00;113;59;54;Starker Schneefall;3;2;3
06.12.2020 14:00;156;75;81;Starker Schneefall;2;2;2
06.12.2020 15:00;140;59;81;Starker Schneefall;2;2;3
06.12.2020 16:00;157;81;76;Starker Schneefall;2;1;1
06.12.2020 17:00;123;57;66;Mäßiger Schneefall;2;1;1
06.12.2020 18:00;122;62;60;Mäßiger Schneefall;2;1;14
06.12.2020 19:00;99;49;50;Mäßiger Schneefall;1;1;7
06.12.2020 20:00;71;37;34;Starker Schneefall;1;0;13
06.12.2020 21:00;40;16;24;Starker Schneefall;1;0;17
06.12.2020 22:00;28;17;11;Starker Schneefall;1;-1;9
06.12.2020 23:00;26;17;9;Starker Schneefall;1;-1;23
07.12.2020 00:00;15;7;8;Starker Schneefall;1;-2;31
07.12.2020 01:00;5;2;3;Starker Schneefall;1;-2;16
07.12.2020 02:00;5;3;2;Starker Schneefall;1;-2;1
07.12.2020 03:00;1;0;1;Starker Schneefall;1;-2;14
07.12.2020 04:00;6;4;2;Starker Schneefall;1;-2;7
07.12.2020 05:00;37;30;7;Starker Schneefall;1;-2;1
07.12.2020 06:00;125;74;51;Starker Schneefall;1;-1;2
07.12.2020 07:00;761;465;296;Starker Schneefall;1;-1;1
07.12.2020 08:00;581;321;260;Mäßiger Schneefall;1;0;0
07.12.2020 09:00;449;260;189;Mäßiger Schneefall;2;0;0
07.12.2020 10:00;294;148;146;Mäßiger Schneefall;2;1;0
07.12.2020 11:00;400;201;199;Leichter Nebel;2;2;0
07.12.2020 12:00;463;186;277;Leichter Nebel;2;2;0
07.12.2020 13:00;760;327;433;Leichter Nebel;2;2;0
07.12.2020 14:00;534;262;272;Leichter Nebel;2;2;0
07.12.2020 15:00;757;380;377;Leichter Nebel;2;2;0
07.12.2020 16:00;686;340;346;Leichter Nebel;1;1;0
07.12.2020 17:00;629;283;346;Leichter Schneefall;0;0;0
07.12.2020 18:00;470;204;266;Leichter Schneefall;0;0;0
07.12.2020 19:00;284;136;148;Leichter Schneefall;-1;-1;0
07.12.2020 20:00;192;81;111;Leichte Schneeschauer;-2;-2;0
07.12.2020 21:00;117;48;69;Leichte Schneeschauer;-2;-2;0
07.12.2020 22:00;74;31;43;Leichte Schneeschauer;-3;-3;0
07.12.2020 23:00;38;18;20;Leichter Nebel;-3;-4;0
08.12.2020 00:00;18;7;11;Leichter Nebel;-4;-5;0
08.12.2020 01:00;10;5;5;Leichter Nebel;-4;-5;0
08.12.2020 02:00;6;4;2;Leicht bewölkt;-4;-5;0
08.12.2020 03:00;8;1;7;Leicht bewölkt;-4;-5;0
08.12.2020 04:00;10;9;1;Leicht bewölkt;-4;-5;0
08.12.2020 05:00;40;27;13;Bewölkt;-4;-5;0
08.12.2020 06:00;152;88;64;Bewölkt;-4;-5;0
08.12.2020 07:00;825;520;305;Bewölkt;-4;-5;0
08.12.2020 08:00;641;349;292;Leicht bewölkt;-3;-5;0
08.12.2020 09:00;518;308;210;Leicht bewölkt;-3;-5;0
08.12.2020 10:00;376;230;146;Leicht bewölkt;-2;-4;0
08.12.2020 11:00;470;231;239;Bedeckt;-1;-4;0
08.12.2020 12:00;560;231;329;Bedeckt;-1;-3;0
08.12.2020 13:00;767;332;435;Bedeckt;0;-3;0
08.12.2020 14:00;573;266;307;Bedeckt;0;-2;0
08.12.2020 15:00;756;357;399;Bedeckt;0;-2;0
08.12.2020 16:00;717;326;391;Bedeckt;0;-1;0
08.12.2020 17:00;696;291;405;Bedeckt;-1;-1;0
08.12.2020 18:00;544;200;344;Bedeckt;-1;-1;0
08.12.2020 19:00;305;129;176;Bedeckt;-1;-2;0
08.12.2020 20:00;184;66;118;Leichter Nebel;-1;-2;0
08.12.2020 21:00;128;61;67;Leichter Nebel;-1;-3;0
08.12.2020 22:00;80;35;45;Leichter Nebel;-1;-3;0
08.12.2020 23:00;67;27;40;Bedeckt;-2;-3;0
09.12.2020 00:00;22;12;10;Bedeckt;-2;-2;0
09.12.2020 01:00;17;8;9;Bedeckt;-1;-2;0
09.12.2020 02:00;4;0;4;Bewölkt;0;-2;4
09.12.2020 03:00;7;3;4;Bewölkt;0;-1;5
09.12.2020 04:00;6;5;1;Bewölkt;0;-1;3
09.12.2020 05:00;32;24;8;Starker Schneefall;0;-1;7
09.12.2020 06:00;134;74;60;Starker Schneefall;0;-1;1
09.12.2020 07:00;763;468;295;Starker Schneefall;1;-1;5
09.12.2020 08:00;570;326;244;Starker Schneefall;1;0;4
09.12.2020 09:00;408;246;162;Starker Schneefall;1;0;5
09.12.2020 10:00;291;171;120;Starker Schneefall;1;0;3
09.12.2020 11:00;360;165;195;Starker Schneefall;1;0;3
09.12.2020 12:00;451;189;262;Starker Schneefall;2;0;4
09.12.2020 13:00;689;338;351;Starker Schneefall;2;1;2
09.12.2020 14:00;388;180;208;Starker Schneefall;2;1;3
09.12.2020 15:00;519;199;320;Starker Schneefall;2;1;4
09.12.2020 16:00;518;264;254;Starker Schneefall;2;1;2
09.12.2020 17:00;543;235;308;Starker Schneefall;2;1;3
09.12.2020 18:00;468;193;275;Starker Schneefall;2;1;4
09.12.2020 19:00;298;126;172;Starker Schneefall;2;1;2
09.12.2020 20:00;209;94;115;Starker Schneefall;1;1;2
09.12.2020 21:00;108;48;60;Starker Schneefall;1;1;3
09.12.2020 22:00;56;25;31;Starker Schneefall;0;0;1
09.12.2020 23:00;60;28;32;Starker Schneefall;0;-1;2
10.12.2020 00:00;33;17;16;Starker Schneefall;-1;-1;3
10.12.2020 01:00;28;14;14;Starker Schneefall;-1;-1;2
10.12.2020 02:00;10;9;1;Starker Schneefall;0;0;1
10.12.2020 03:00;3;1;2;Starker Schneefall;0;0;1
10.12.2020 04:00;9;7;2;Starker Schneefall;0;0;1
10.12.2020 05:00;36;25;11;Mäßiger Schneefall;0;-1;0
10.12.2020 06:00;135;78;57;Mäßiger Schneefall;-1;-2;0
10.12.2020 07:00;805;489;316;Mäßiger Schneefall;-1;-2;0
10.12.2020 08:00;665;384;281;Stellenweise mäßiger Schneefall;-1;-2;0
10.12.2020 09:00;478;278;200;Stellenweise mäßiger Schneefall;-1;-2;0
10.12.2020 10:00;341;197;144;Stellenweise mäßiger Schneefall;-1;-1;0
10.12.2020 11:00;480;233;247;Leicht bewölkt;0;-1;0
10.12.2020 12:00;552;250;302;Leicht bewölkt;1;0;0
10.12.2020 13:00;756;324;432;Leicht bewölkt;1;0;0
10.12.2020 14:00;628;304;324;Leicht bewölkt;1;1;0
10.12.2020 15:00;795;409;386;Leicht bewölkt;1;1;0
10.12.2020 16:00;730;339;391;Leicht bewölkt;0;0;0
10.12.2020 17:00;737;335;402;Leicht bewölkt;0;-1;0
10.12.2020 18:00;523;204;319;Leicht bewölkt;-1;-1;0
10.12.2020 19:00;334;132;202;Leicht bewölkt;-2;-2;0
10.12.2020 20:00;218;90;128;Leicht bewölkt;-2;-2;0
10.12.2020 21:00;127;44;83;Leicht bewölkt;-2;-2;0
10.12.2020 22:00;83;38;45;Leicht bewölkt;-3;-3;0
10.12.2020 23:00;53;24;29;Leicht bewölkt;-3;-3;0
11.12.2020 00:00;29;14;15;Leicht bewölkt;-3;-3;0
11.12.2020 01:00;18;5;13;Leicht bewölkt;-3;-3;0
11.12.2020 02:00;2;1;1;Leicht bewölkt;-3;-3;0
11.12.2020 03:00;5;1;4;Leicht bewölkt;-3;-3;0
11.12.2020 04:00;6;4;2;Leicht bewölkt;-2;-3;0
11.12.2020 05:00;37;22;15;Leicht bewölkt;-2;-3;0
11.12.2020 06:00;120;71;49;Leicht bewölkt;-2;-2;0
11.12.2020 07:00;784;505;279;Leicht bewölkt;-1;-2;0
11.12.2020 08:00;689;375;314;Leicht bewölkt;0;-1;0
11.12.2020 09:00;515;311;204;Leicht bewölkt;0;0;0
11.12.2020 10:00;445;265;180;Leicht bewölkt;1;1;0
11.12.2020 11:00;542;253;289;Leicht bewölkt;2;2;0
11.12.2020 12:00;642;279;363;Leicht bewölkt;3;3;0
11.12.2020 13:00;886;355;531;Leicht bewölkt;3;3;0
11.12.2020 14:00;758;369;389;Leicht bewölkt;3;3;0
11.12.2020 15:00;694;366;328;Leicht bewölkt;3;3;0
11.12.2020 16:00;684;315;369;Leicht bewölkt;3;2;0
11.12.2020 17:00;578;259;319;Bedeckt;2;1;0
11.12.2020 18:00;503;212;291;Bedeckt;2;1;0
11.12.2020 19:00;354;119;235;Bedeckt;1;1;0
11.12.2020 20:00;206;83;123;Bedeckt;1;1;0
11.12.2020 21:00;133;51;82;Bedeckt;1;1;0
11.12.2020 22:00;98;40;58;Bedeckt;0;0;0
11.12.2020 23:00;108;44;64;Leicht bewölkt;0;0;0
12.12.2020 00:00;70;34;36;Leicht bewölkt;-1;-1;0
12.12.2020 01:00;45;26;19;Leicht bewölkt;-1;-1;0
12.12.2020 02:00;27;15;12;Leicht bewölkt;0;-1;0
12.12.2020 03:00;19;9;10;Leicht bewölkt;0;-1;0
12.12.2020 04:00;13;9;4;Leicht bewölkt;0;-1;0
12.12.2020 05:00;18;13;5;Leicht bewölkt;0;-1;1
12.12.2020 06:00;32;16;16;Leicht bewölkt;0;-1;1
12.12.2020 07:00;61;34;27;Leicht bewölkt;1;0;1
12.12.2020 08:00;119;71;48;Leichter Eisregen;2;0;0
12.12.2020 09:00;175;106;69;Leichter Eisregen;2;1;0
12.12.2020 10:00;267;166;101;Leichter Eisregen;3;2;0
12.12.2020 11:00;280;148;132;Bedeckt;4;3;0
12.12.2020 12:00;366;194;172;Bedeckt;5;5;0
12.12.2020 13:00;427;240;187;Bedeckt;5;4;0
12.12.2020 14:00;430;186;244;Bedeckt;5;4;0
12.12.2020 15:00;406;195;211;Bedeckt;5;4;0
12.12.2020 16:00;415;192;223;Bedeckt;4;3;0
12.12.2020 17:00;356;161;195;Bedeckt;4;2;2
12.12.2020 18:00;260;117;143;Bedeckt;3;2;3
12.12.2020 19:00;255;118;137;Bedeckt;3;1;2
12.12.2020 20:00;84;34;50;Leichter Regenfall;3;1;6
12.12.2020 21:00;27;14;13;Leichter Regenfall;3;1;8
12.12.2020 22:00;18;9;9;Leichter Regenfall;3;1;4
12.12.2020 23:00;10;2;8;Nieselregen;3;1;1
13.12.2020 00:00;8;4;4;Nieselregen;2;1;1
13.12.2020 01:00;2;0;2;Nieselregen;2;1;1
13.12.2020 02:00;3;1;2;Nieselregen;2;1;3
13.12.2020 03:00;1;1;0;Nieselregen;2;0;4
13.12.2020 04:00;2;1;1;Nieselregen;2;0;2
13.12.2020 05:00;10;4;6;Leichter Regenfall;2;0;5
13.12.2020 06:00;15;9;6;Leichter Regenfall;3;1;7
13.12.2020 07:00;16;8;8;Leichter Regenfall;3;1;3
13.12.2020 08:00;28;15;13;Leichter Regenfall;3;1;5
13.12.2020 09:00;94;52;42;Leichter Regenfall;3;1;6
13.12.2020 10:00;108;58;50;Leichter Regenfall;3;2;3
13.12.2020 11:00;132;60;72;Leichter Regenfall;4;2;5
13.12.2020 12:00;159;85;74;Leichter Regenfall;4;2;7
13.12.2020 13:00;213;102;111;Leichter Regenfall;4;3;4
13.12.2020 14:00;210;108;102;Leichter Regenfall;4;3;2
13.12.2020 15:00;281;138;143;Leichter Regenfall;4;3;3
13.12.2020 16:00;279;122;157;Leichter Regenfall;4;3;2
13.12.2020 17:00;229;99;130;Stellenweiser Regenfall;3;3;0
13.12.2020 18:00;169;97;72;Stellenweiser Regenfall;3;3;0
13.12.2020 19:00;180;92;88;Stellenweiser Regenfall;2;2;0
13.12.2020 20:00;59;29;30;Leicht bewölkt;2;2;0
13.12.2020 21:00;20;10;10;Leicht bewölkt;1;1;0
13.12.2020 22:00;12;3;9;Leicht bewölkt;1;1;0
13.12.2020 23:00;6;3;3;Leicht bewölkt;1;0;0
14.12.2020 00:00;4;0;4;Leicht bewölkt;0;-1;0
14.12.2020 01:00;3;2;1;Leicht bewölkt;0;-1;0
14.12.2020 02:00;7;7;0;Leicht bewölkt;0;-1;0
14.12.2020 03:00;0;0;0;Leicht bewölkt;-1;-2;0
14.12.2020 04:00;3;1;2;Leicht bewölkt;-1;-2;0
14.12.2020 05:00;39;24;15;Leicht bewölkt;-1;-2;0
14.12.2020 06:00;149;90;59;Leicht bewölkt;-1;-2;0
14.12.2020 07:00;833;536;297;Leicht bewölkt;0;0;0
14.12.2020 08:00;644;366;278;Leicht bewölkt;1;1;0
14.12.2020 09:00;581;380;201;Leicht bewölkt;2;2;0
14.12.2020 10:00;482;265;217;Leicht bewölkt;3;3;0
14.12.2020 11:00;560;289;271;Leicht bewölkt;4;4;0
14.12.2020 12:00;653;275;378;Leicht bewölkt;5;5;0
14.12.2020 13:00;818;370;448;Leicht bewölkt;5;5;0
14.12.2020 14:00;718;336;382;Leicht bewölkt;4;4;0
14.12.2020 15:00;855;398;457;Leicht bewölkt;4;4;0
14.12.2020 16:00;891;441;450;Leicht bewölkt;3;3;0
14.12.2020 17:00;804;344;460;Leicht bewölkt;3;3;0
14.12.2020 18:00;581;207;374;Leicht bewölkt;2;2;0
14.12.2020 19:00;400;141;259;Leicht bewölkt;1;1;0
14.12.2020 20:00;143;61;82;Bewölkt;-1;-1;0
14.12.2020 21:00;40;11;29;Bewölkt;-2;-2;0
14.12.2020 22:00;16;7;9;Bewölkt;-1;-1;0
14.12.2020 23:00;6;1;5;Leicht bewölkt;1;1;0
15.12.2020 00:00;2;1;1;Leicht bewölkt;2;2;0
15.12.2020 01:00;4;2;2;Leicht bewölkt;2;2;0
15.12.2020 02:00;2;2;0;Bedeckt;2;1;0
15.12.2020 03:00;2;0;2;Bedeckt;2;1;0
15.12.2020 04:00;5;4;1;Bedeckt;1;1;0
15.12.2020 05:00;41;29;12;Leicht bewölkt;1;1;0
15.12.2020 06:00;150;85;65;Leicht bewölkt;1;1;0
15.12.2020 07:00;804;506;298;Leicht bewölkt;2;2;0
15.12.2020 08:00;620;353;267;Leicht bewölkt;3;2;0
15.12.2020 09:00;553;351;202;Leicht bewölkt;3;3;0
15.12.2020 10:00;529;300;229;Leicht bewölkt;4;4;0
15.12.2020 11:00;621;322;299;Bedeckt;5;5;0
15.12.2020 12:00;714;318;396;Bedeckt;6;6;0
15.12.2020 13:00;854;345;509;Bedeckt;5;5;0
15.12.2020 14:00;689;325;364;Bedeckt;5;5;0
15.12.2020 15:00;908;467;441;Bedeckt;5;5;0
15.12.2020 16:00;931;451;480;Bedeckt;5;5;0
15.12.2020 17:00;941;379;562;Leicht bewölkt;4;4;1
15.12.2020 18:00;606;223;383;Leicht bewölkt;4;4;1
15.12.2020 19:00;483;173;310;Leicht bewölkt;2;2;1
15.12.2020 20:00;130;57;73;Stellenweiser Nieselregen;1;1;1
15.12.2020 21:00;42;18;24;Stellenweiser Nieselregen;0;0;1
15.12.2020 22:00;19;11;8;Stellenweiser Nieselregen;1;1;1
15.12.2020 23:00;13;3;10;Stellenweiser Nieselregen;3;3;1
16.12.2020 00:00;7;1;6;Stellenweiser Nieselregen;4;4;1
16.12.2020 01:00;3;3;0;Stellenweiser Nieselregen;4;4;1
16.12.2020 02:00;1;1;0;Nieselregen;4;4;1
16.12.2020 03:00;4;3;1;Nieselregen;4;4;1
16.12.2020 04:00;7;3;4;Nieselregen;4;4;1
16.12.2020 05:00;39;25;14;Nieselregen;5;3;2
16.12.2020 06:00;133;78;55;Nieselregen;5;3;3
16.12.2020 07:00;328;188;140;Nieselregen;5;4;1
16.12.2020 08:00;458;273;185;Stellenweiser leichter Regenfall;6;4;1
16.12.2020 09:00;339;183;156;Stellenweiser leichter Regenfall;6;5;1
16.12.2020 10:00;327;173;154;Stellenweiser leichter Regenfall;7;6;1
16.12.2020 11:00;365;158;207;Leicht bewölkt;8;8;0
16.12.2020 12:00;402;186;216;Leicht bewölkt;9;9;0
16.12.2020 13:00;396;192;204;Leicht bewölkt;9;9;0
16.12.2020 14:00;440;199;241;Leicht bewölkt;9;9;0
16.12.2020 15:00;518;247;271;Leicht bewölkt;9;9;0
16.12.2020 16:00;544;246;298;Leicht bewölkt;8;8;0
16.12.2020 17:00;534;235;299;Leicht bewölkt;7;7;0
16.12.2020 18:00;405;175;230;Leicht bewölkt;7;7;0
16.12.2020 19:00;320;142;178;Leicht bewölkt;6;6;0
16.12.2020 20:00;120;59;61;Leicht bewölkt;5;5;0
16.12.2020 21:00;41;21;20;Leicht bewölkt;4;4;0
16.12.2020 22:00;16;6;10;Leicht bewölkt;4;4;0
16.12.2020 23:00;9;2;7;Leicht bewölkt;3;3;0
17.12.2020 00:00;4;2;2;Leicht bewölkt;3;3;0
17.12.2020 01:00;4;3;1;Leicht bewölkt;3;2;0
17.12.2020 02:00;1;1;0;Leicht bewölkt;3;2;0
17.12.2020 03:00;2;0;2;Leicht bewölkt;2;2;0
17.12.2020 04:00;7;5;2;Leicht bewölkt;2;2;0
17.12.2020 05:00;38;22;16;Leicht bewölkt;2;1;0
17.12.2020 06:00;127;82;45;Leicht bewölkt;2;1;0
17.12.2020 07:00;332;188;144;Leicht bewölkt;2;1;0
17.12.2020 08:00;426;255;171;Leicht bewölkt;3;2;0
17.12.2020 09:00;326;171;155;Leicht bewölkt;3;3;0
17.12.2020 10:00;312;154;158;Leicht bewölkt;5;4;0
17.12.2020 11:00;330;181;149;Leicht bewölkt;6;6;0
17.12.2020 12:00;440;193;247;Leicht bewölkt;7;7;0
17.12.2020 13:00;459;240;219;Leicht bewölkt;7;7;0
17.12.2020 14:00;449;215;234;Leicht bewölkt;7;7;0
17.12.2020 15:00;554;263;291;Leicht bewölkt;6;6;0
17.12.2020 16:00;621;294;327;Leicht bewölkt;6;6;0
17.12.2020 17:00;538;246;292;Leicht bewölkt;5;5;0
17.12.2020 18:00;405;177;228;Leicht bewölkt;4;4;0
17.12.2020 19:00;306;122;184;Leicht bewölkt;3;3;0
17.12.2020 20:00;119;55;64;Leicht bewölkt;2;2;0
17.12.2020 21:00;35;11;24;Leicht bewölkt;0;0;0
17.12.2020 22:00;13;2;11;Leicht bewölkt;1;1;0
17.12.2020 23:00;9;4;5;Leicht bewölkt;2;1;0
18.12.2020 00:00;11;7;4;Leicht bewölkt;3;2;0
18.12.2020 01:00;6;5;1;Leicht bewölkt;3;2;0
18.12.2020 02:00;2;1;1;Leicht bewölkt;2;2;0
18.12.2020 03:00;1;0;1;Leicht bewölkt;2;2;0
18.12.2020 04:00;6;5;1;Leicht bewölkt;2;2;0
18.12.2020 05:00;35;22;13;Leicht bewölkt;2;1;0
18.12.2020 06:00;107;60;47;Leicht bewölkt;1;1;0
18.12.2020 07:00;318;197;121;Leicht bewölkt;2;2;0
18.12.2020 08:00;386;245;141;Leicht bewölkt;3;3;0
18.12.2020 09:00;370;206;164;Leicht bewölkt;4;4;0
18.12.2020 10:00;364;186;178;Leicht bewölkt;5;5;0
18.12.2020 11:00;391;200;191;Leicht bewölkt;6;6;0
18.12.2020 12:00;437;187;250;Leicht bewölkt;8;8;0
18.12.2020 13:00;467;211;256;Leicht bewölkt;7;7;0
18.12.2020 14:00;447;216;231;Leicht bewölkt;7;7;0
18.12.2020 15:00;479;237;242;Leicht bewölkt;6;6;0
18.12.2020 16:00;455;189;266;Leicht bewölkt;6;6;0
18.12.2020 17:00;399;160;239;Leicht bewölkt;5;5;0
18.12.2020 18:00;307;146;161;Leicht bewölkt;4;4;0
18.12.2020 19:00;257;118;139;Leicht bewölkt;4;4;0
18.12.2020 20:00;75;34;41;Leicht bewölkt;3;3;0
18.12.2020 21:00;23;9;14;Leicht bewölkt;3;3;0
18.12.2020 22:00;16;9;7;Leicht bewölkt;3;3;0
18.12.2020 23:00;14;8;6;Leicht bewölkt;3;2;0
19.12.2020 00:00;3;1;2;Leicht bewölkt;3;2;0
19.12.2020 01:00;2;1;1;Leicht bewölkt;2;2;0
19.12.2020 02:00;4;4;0;Leicht bewölkt;2;2;0
19.12.2020 03:00;3;2;1;Leicht bewölkt;2;2;0
19.12.2020 04:00;4;4;0;Leicht bewölkt;2;2;0
19.12.2020 05:00;19;12;7;Leicht bewölkt;1;1;0
19.12.2020 06:00;34;22;12;Leicht bewölkt;1;1;0
19.12.2020 07:00;56;24;32;Leicht bewölkt;2;2;0
19.12.2020 08:00;104;67;37;Leicht bewölkt;2;2;0
19.12.2020 09:00;173;89;84;Leicht bewölkt;3;2;0
19.12.2020 10:00;227;119;108;Leicht bewölkt;4;4;0
19.12.2020 11:00;288;147;141;Leicht bewölkt;6;6;0
19.12.2020 12:00;299;158;141;Leicht bewölkt;8;7;0
19.12.2020 13:00;344;164;180;Leicht bewölkt;7;7;0
19.12.2020 14:00;326;153;173;Leicht bewölkt;7;6;0
19.12.2020 15:00;347;169;178;Leicht bewölkt;6;6;0
19.12.2020 16:00;306;137;169;Leicht bewölkt;5;5;0
19.12.2020 17:00;248;110;138;Leicht bewölkt;4;4;0
19.12.2020 18:00;194;88;106;Leicht bewölkt;4;4;0
19.12.2020 19:00;190;88;102;Leicht bewölkt;3;3;0
19.12.2020 20:00;59;26;33;Leicht bewölkt;3;3;0
19.12.2020 21:00;16;7;9;Leicht bewölkt;3;2;0
19.12.2020 22:00;19;9;10;Leicht bewölkt;3;2;0
19.12.2020 23:00;8;5;3;Leicht bewölkt;2;2;0
20.12.2020 00:00;2;0;2;Leicht bewölkt;2;1;0
20.12.2020 01:00;5;2;3;Leicht bewölkt;2;1;0
20.12.2020 02:00;0;0;0;Leicht bewölkt;2;1;0
20.12.2020 03:00;5;2;3;Leicht bewölkt;2;1;0
20.12.2020 04:00;4;3;1;Leicht bewölkt;2;1;0
20.12.2020 05:00;7;3;4;Leicht bewölkt;1;1;0
20.12.2020 06:00;15;10;5;Leicht bewölkt;1;1;0
20.12.2020 07:00;12;4;8;Leicht bewölkt;2;2;0
20.12.2020 08:00;40;15;25;Leicht bewölkt;2;2;0
20.12.2020 09:00;85;45;40;Leicht bewölkt;3;3;0
20.12.2020 10:00;107;54;53;Leicht bewölkt;3;3;0
20.12.2020 11:00;163;68;95;Bedeckt;4;4;0
20.12.2020 12:00;196;96;100;Bedeckt;5;5;0
20.12.2020 13:00;217;109;108;Bedeckt;5;5;0
20.12.2020 14:00;244;112;132;Leicht bewölkt;5;4;0
20.12.2020 15:00;258;118;140;Leicht bewölkt;4;4;0
20.12.2020 16:00;229;127;102;Leicht bewölkt;3;3;0
20.12.2020 17:00;189;91;98;Bedeckt;2;2;0
20.12.2020 18:00;163;65;98;Bedeckt;1;0;0
20.12.2020 19:00;148;84;64;Bedeckt;-1;-1;0
20.12.2020 20:00;52;23;29;Bedeckt;-3;-3;1
20.12.2020 21:00;14;6;8;Bedeckt;-4;-4;1
20.12.2020 22:00;5;1;4;Bedeckt;-2;-2;1
20.12.2020 23:00;2;1;1;Nieselregen;0;0;1
21.12.2020 00:00;4;1;3;Nieselregen;2;2;1
21.12.2020 01:00;3;2;1;Nieselregen;2;2;1
21.12.2020 02:00;0;0;0;Stellenweiser Nieselregen;3;3;1
21.12.2020 03:00;2;1;1;Stellenweiser Nieselregen;3;3;1
21.12.2020 04:00;5;3;2;Stellenweiser Nieselregen;3;3;0
21.12.2020 05:00;33;22;11;Stellenweiser Regenfall;3;3;0
21.12.2020 06:00;101;62;39;Stellenweiser Regenfall;2;2;0
21.12.2020 07:00;234;140;94;Stellenweiser Regenfall;3;3;0
21.12.2020 08:00;306;178;128;Leicht bewölkt;3;3;0
21.12.2020 09:00;316;187;129;Leicht bewölkt;4;4;0
21.12.2020 10:00;317;186;131;Leicht bewölkt;5;5;0
21.12.2020 11:00;362;176;186;Leicht bewölkt;6;6;0
21.12.2020 12:00;356;148;208;Leicht bewölkt;7;7;0
21.12.2020 13:00;390;194;196;Leicht bewölkt;7;7;0
21.12.2020 14:00;415;206;209;Leicht bewölkt;7;7;0
21.12.2020 15:00;468;232;236;Leicht bewölkt;7;7;0
21.12.2020 16:00;513;259;254;Leicht bewölkt;7;7;0
21.12.2020 17:00;429;163;266;Leicht bewölkt;6;6;0
21.12.2020 18:00;277;97;180;Leicht bewölkt;6;6;0
21.12.2020 19:00;204;79;125;Leicht bewölkt;4;4;0
21.12.2020 20:00;65;26;39;Bewölkt;3;3;1
21.12.2020 21:00;35;20;15;Bewölkt;2;2;2
21.12.2020 22:00;7;1;6;Bewölkt;2;2;1
21.12.2020 23:00;6;3;3;Leichter Regenfall;3;3;3
22.12.2020 00:00;3;2;1;Leichter Regenfall;4;3;4
22.12.2020 01:00;1;1;0;Leichter Regenfall;5;4;2
22.12.2020 02:00;0;0;0;Nieselregen;6;4;3
22.12.2020 03:00;2;0;2;Nieselregen;7;5;4
22.12.2020 04:00;12;10;2;Nieselregen;7;5;2
22.12.2020 05:00;32;19;13;Leichter Regenfall;8;5;1
22.12.2020 06:00;97;62;35;Leichter Regenfall;8;6;1
22.12.2020 07:00;218;138;80;Leichter Regenfall;8;6;1
22.12.2020 08:00;331;207;124;Bewölkt;9;7;0
22.12.2020 09:00;345;212;133;Bewölkt;9;7;0
22.12.2020 10:00;415;224;191;Bewölkt;9;7;0
22.12.2020 11:00;425;215;210;Stellenweiser Regenfall;10;8;0
22.12.2020 12:00;405;172;233;Stellenweiser Regenfall;10;8;0
22.12.2020 13:00;375;159;216;Stellenweiser Regenfall;10;8;0
22.12.2020 14:00;532;259;273;Bedeckt;10;8;1
22.12.2020 15:00;532;243;289;Bedeckt;10;8;1
22.12.2020 16:00;475;228;247;Bedeckt;9;8;1
22.12.2020 17:00;433;184;249;Stellenweiser Nieselregen;8;7;3
22.12.2020 18:00;240;98;142;Stellenweiser Nieselregen;7;7;4
22.12.2020 19:00;218;106;112;Stellenweiser Nieselregen;6;5;2
22.12.2020 20:00;79;37;42;Leichter Regenfall;4;4;1
22.12.2020 21:00;31;13;18;Leichter Regenfall;2;2;2
22.12.2020 22:00;15;6;9;Leichter Regenfall;4;3;1
22.12.2020 23:00;8;4;4;Leicht bewölkt;6;5;0
23.12.2020 00:00;5;2;3;Leicht bewölkt;8;6;0
23.12.2020 01:00;6;2;4;Leicht bewölkt;7;6;0
23.12.2020 02:00;1;0;1;Leicht bewölkt;7;6;0
23.12.2020 03:00;4;2;2;Leicht bewölkt;7;5;0
23.12.2020 04:00;4;4;0;Leicht bewölkt;6;5;0
23.12.2020 05:00;25;16;9;Leicht bewölkt;6;5;0
23.12.2020 06:00;77;53;24;Leicht bewölkt;6;6;0
23.12.2020 07:00;186;99;87;Leicht bewölkt;7;6;0
23.12.2020 08:00;239;136;103;Leicht bewölkt;7;6;0
23.12.2020 09:00;265;136;129;Leicht bewölkt;7;7;0
23.12.2020 10:00;347;178;169;Leicht bewölkt;8;8;0
23.12.2020 11:00;384;195;189;Leicht bewölkt;9;9;0
23.12.2020 12:00;452;210;242;Leicht bewölkt;10;10;0
23.12.2020 13:00;371;184;187;Leicht bewölkt;10;10;0
23.12.2020 14:00;382;158;224;Bedeckt;10;10;0
23.12.2020 15:00;400;192;208;Bedeckt;10;10;0
23.12.2020 16:00;386;197;189;Bedeckt;9;9;0
23.12.2020 17:00;325;156;169;Bedeckt;9;8;0
23.12.2020 18:00;196;78;118;Bedeckt;8;7;0
23.12.2020 19:00;200;90;110;Bedeckt;7;6;0
23.12.2020 20:00;60;31;29;Bedeckt;6;5;1
23.12.2020 21:00;22;7;15;Bedeckt;4;4;1
23.12.2020 22:00;13;3;10;Bedeckt;6;5;1
23.12.2020 23:00;8;5;3;Leichter Regenfall;7;6;2
24.12.2020 00:00;5;4;1;Leichter Regenfall;9;8;3
24.12.2020 01:00;2;2;0;Leichter Regenfall;9;7;2
24.12.2020 02:00;5;4;1;Bedeckt;9;7;14
24.12.2020 03:00;1;0;1;Bedeckt;9;7;19
24.12.2020 04:00;9;7;2;Bedeckt;8;6;9
24.12.2020 05:00;8;5;3;Mäßiger Regenfall;8;5;7
24.12.2020 06:00;39;23;16;Mäßiger Regenfall;7;4;9
24.12.2020 07:00;66;51;15;Mäßiger Regenfall;7;4;5
24.12.2020 08:00;139;89;50;Bedeckt;7;4;0
24.12.2020 09:00;175;88;87;Bedeckt;7;4;0
24.12.2020 10:00;297;158;139;Bedeckt;7;4;0
24.12.2020 11:00;303;134;169;Stellenweiser Regenfall;8;5;0
24.12.2020 12:00;255;103;152;Stellenweiser Regenfall;8;5;0
24.12.2020 13:00;184;92;92;Stellenweiser Regenfall;8;5;0
24.12.2020 14:00;154;73;81;Stellenweiser Regenfall;8;4;0
24.12.2020 15:00;118;50;68;Stellenweiser Regenfall;8;4;0
24.12.2020 16:00;133;51;82;Stellenweiser Regenfall;7;4;0
24.12.2020 17:00;89;54;35;Bedeckt;7;3;1
24.12.2020 18:00;39;23;16;Bedeckt;6;2;1
24.12.2020 19:00;35;14;21;Bedeckt;6;2;0
24.12.2020 20:00;27;10;17;Nieselregen;5;2;7
24.12.2020 21:00;35;21;14;Nieselregen;5;1;9
24.12.2020 22:00;23;16;7;Nieselregen;4;1;5
24.12.2020 23:00;31;11;20;Leichter Eisregen;3;1;6
25.12.2020 00:00;25;10;15;Leichter Eisregen;3;1;8
25.12.2020 01:00;12;7;5;Leichter Eisregen;3;0;4
25.12.2020 02:00;8;5;3;Starker Schneefall;2;0;6
25.12.2020 03:00;7;0;7;Starker Schneefall;2;0;8
25.12.2020 04:00;4;2;2;Starker Schneefall;2;0;4
25.12.2020 05:00;4;3;1;Starker Schneefall;2;0;6
25.12.2020 06:00;20;10;10;Starker Schneefall;2;1;8
25.12.2020 07:00;8;3;5;Starker Schneefall;2;1;4
25.12.2020 08:00;11;5;6;Stellenweise starker Schneefall;2;1;3
25.12.2020 09:00;27;16;11;Stellenweise starker Schneefall;2;1;4
25.12.2020 10:00;52;25;27;Stellenweise starker Schneefall;2;1;2
25.12.2020 11:00;71;30;41;Mäßige bis starke Schneefälle;2;1;0
25.12.2020 12:00;59;35;24;Mäßige bis starke Schneefälle;2;1;0
25.12.2020 13:00;68;34;34;Mäßige bis starke Schneefälle;2;1;0
25.12.2020 14:00;64;25;39;Bewölkt;2;1;2
25.12.2020 15:00;99;52;47;Bewölkt;2;1;2
25.12.2020 16:00;105;50;55;Bewölkt;2;0;1
25.12.2020 17:00;82;47;35;Mäßige bis starke Schneefälle;1;-1;5
25.12.2020 18:00;52;28;24;Mäßige bis starke Schneefälle;1;-2;6
25.12.2020 19:00;42;17;25;Mäßige bis starke Schneefälle;0;-3;3
25.12.2020 20:00;44;22;22;Starker Schneefall;0;-4;3
25.12.2020 21:00;21;10;11;Starker Schneefall;-1;-5;4
25.12.2020 22:00;23;12;11;Starker Schneefall;-1;-5;2
25.12.2020 23:00;21;14;7;Stellenweise starker Schneefall;-2;-5;1
26.12.2020 00:00;7;2;5;Stellenweise starker Schneefall;-2;-5;2
26.12.2020 01:00;14;5;9;Stellenweise starker Schneefall;-2;-5;1
26.12.2020 02:00;2;0;2;Stellenweise starker Schneefall;-2;-5;0
26.12.2020 03:00;3;2;1;Stellenweise starker Schneefall;-2;-5;0
26.12.2020 04:00;2;2;0;Stellenweise starker Schneefall;-2;-4;0
26.12.2020 05:00;4;1;3;Leicht bewölkt;-2;-4;0
26.12.2020 06:00;14;7;7;Leicht bewölkt;-3;-3;0
26.12.2020 07:00;14;3;11;Leicht bewölkt;-2;-3;0
26.12.2020 08:00;14;7;7;Stellenweise leichter Schneefall;-2;-2;0
26.12.2020 09:00;50;21;29;Stellenweise leichter Schneefall;-1;-1;0
26.12.2020 10:00;70;27;43;Stellenweise leichter Schneefall;-1;-1;0
26.12.2020 11:00;87;36;51;Leicht bewölkt;0;0;0
26.12.2020 12:00;152;62;90;Leicht bewölkt;1;1;0
26.12.2020 13:00;184;72;112;Leicht bewölkt;1;0;0
26.12.2020 14:00;207;119;88;Leicht bewölkt;1;0;0
26.12.2020 15:00;181;91;90;Leicht bewölkt;1;0;0
26.12.2020 16:00;147;83;64;Leicht bewölkt;0;0;0
26.12.2020 17:00;119;56;63;Leicht bewölkt;0;-1;0
26.12.2020 18:00;67;33;34;Leicht bewölkt;0;-2;0
26.12.2020 19:00;73;46;27;Leicht bewölkt;-1;-2;0
26.12.2020 20:00;44;12;32;Leicht bewölkt;-1;-3;0
26.12.2020 21:00;16;5;11;Leicht bewölkt;-1;-3;0
26.12.2020 22:00;16;7;9;Leicht bewölkt;-2;-4;0
26.12.2020 23:00;27;16;11;Leicht bewölkt;-3;-5;0
27.12.2020 00:00;14;10;4;Leicht bewölkt;-4;-6;0
27.12.2020 01:00;8;4;4;Leicht bewölkt;-4;-6;0
27.12.2020 02:00;2;2;0;Leicht bewölkt;-4;-7;0
27.12.2020 03:00;4;4;0;Leicht bewölkt;-4;-7;0
27.12.2020 04:00;9;9;0;Leicht bewölkt;-4;-7;0
27.12.2020 05:00;5;3;2;Leicht bewölkt;-4;-7;0
27.12.2020 06:00;11;6;5;Leicht bewölkt;-4;-7;0
27.12.2020 07:00;6;4;2;Leicht bewölkt;-4;-6;0
27.12.2020 08:00;18;11;7;Leicht bewölkt;-3;-5;0
27.12.2020 09:00;47;24;23;Leicht bewölkt;-2;-5;0
27.12.2020 10:00;59;38;21;Leicht bewölkt;-1;-3;0
27.12.2020 11:00;95;33;62;Bedeckt;0;-2;0
27.12.2020 12:00;107;53;54;Bedeckt;1;-1;0
27.12.2020 13:00;128;64;64;Bedeckt;1;-1;0
27.12.2020 14:00;148;64;84;Bedeckt;1;0;0
27.12.2020 15:00;164;78;86;Bedeckt;1;0;0
27.12.2020 16:00;144;89;55;Bedeckt;1;0;0
27.12.2020 17:00;127;71;56;Bewölkt;0;-1;0
27.12.2020 18:00;86;40;46;Bewölkt;0;-1;0
27.12.2020 19:00;85;47;38;Bewölkt;0;-2;0
27.12.2020 20:00;31;15;16;Bedeckt;0;-2;0
27.12.2020 21:00;14;5;9;Bedeckt;0;-3;0
27.12.2020 22:00;8;4;4;Bedeckt;-1;-4;0
27.12.2020 23:00;9;3;6;Leicht bewölkt;-2;-4;0
28.12.2020 00:00;5;4;1;Leicht bewölkt;-3;-5;0
28.12.2020 01:00;2;2;0;Leicht bewölkt;-2;-5;0
28.12.2020 02:00;1;1;0;Stellenweise mäßiger Schneefall;-2;-4;0
28.12.2020 03:00;4;2;2;Stellenweise mäßiger Schneefall;-1;-4;0
28.12.2020 04:00;5;1;4;Stellenweise mäßiger Schneefall;-1;-3;0
28.12.2020 05:00;19;11;8;Leichter Schneefall;-1;-3;0
28.12.2020 06:00;64;42;22;Leichter Schneefall;-1;-2;0
28.12.2020 07:00;100;68;32;Leichter Schneefall;-1;-2;0
28.12.2020 08:00;126;76;50;Mäßiger Schneefall;-1;-2;1
28.12.2020 09:00;134;76;58;Mäßiger Schneefall;0;-2;1
28.12.2020 10:00;135;87;48;Mäßiger Schneefall;0;-2;1
28.12.2020 11:00;161;81;80;Starker Schneefall;1;-2;4
28.12.2020 12:00;169;71;98;Starker Schneefall;1;-3;5
28.12.2020 13:00;187;85;102;Starker Schneefall;1;-2;3
28.12.2020 14:00;186;96;90;Starker Schneefall;1;-1;2
28.12.2020 15:00;183;76;107;Starker Schneefall;1;-1;3
28.12.2020 16:00;224;108;116;Starker Schneefall;1;-2;2
28.12.2020 17:00;224;99;125;Stellenweise mäßiger Schneefall;0;-2;0
28.12.2020 18:00;145;67;78;Stellenweise mäßiger Schneefall;0;-3;0
28.12.2020 19:00;139;65;74;Stellenweise mäßiger Schneefall;-1;-3;0
28.12.2020 20:00;38;16;22;Stellenweiser Schneefall;-1;-4;0
28.12.2020 21:00;17;7;10;Stellenweiser Schneefall;-2;-5;0
28.12.2020 22:00;8;6;2;Stellenweiser Schneefall;-2;-4;0
28.12.2020 23:00;9;5;4;Leicht bewölkt;-2;-4;0
29.12.2020 00:00;6;3;3;Leicht bewölkt;-2;-4;0
29.12.2020 01:00;4;2;2;Leicht bewölkt;-2;-4;0
29.12.2020 02:00;3;1;2;Bedeckt;-2;-4;0
29.12.2020 03:00;3;1;2;Bedeckt;-2;-4;0
29.12.2020 04:00;8;4;4;Bedeckt;-2;-4;0
29.12.2020 05:00;15;11;4;Stellenweise mäßiger Schneefall;-2;-4;0
29.12.2020 06:00;69;45;24;Stellenweise mäßiger Schneefall;-2;-5;0
29.12.2020 07:00;95;53;42;Stellenweise mäßiger Schneefall;-1;-4;0
29.12.2020 08:00;127;79;48;Bewölkt;-1;-3;0
29.12.2020 09:00;190;123;67;Bewölkt;0;-3;0
29.12.2020 10:00;264;147;117;Bewölkt;1;-2;0
29.12.2020 11:00;306;146;160;Leichter Schneefall;1;-1;0
29.12.2020 12:00;289;128;161;Leichter Schneefall;2;0;0
29.12.2020 13:00;317;138;179;Leichter Schneefall;2;0;0
29.12.2020 14:00;404;189;215;Stellenweise mäßiger Schneefall;1;0;1
29.12.2020 15:00;377;182;195;Stellenweise mäßiger Schneefall;1;0;1
29.12.2020 16:00;356;173;183;Stellenweise mäßiger Schneefall;1;0;0
29.12.2020 17:00;190;92;98;Stellenweise mäßiger Schneefall;1;0;1
29.12.2020 18:00;124;51;73;Stellenweise mäßiger Schneefall;0;0;1
29.12.2020 19:00;160;73;87;Stellenweise mäßiger Schneefall;0;-1;1
29.12.2020 20:00;45;19;26;Starker Schneefall;0;-1;0
29.12.2020 21:00;12;6;6;Starker Schneefall;0;-2;0
29.12.2020 22:00;6;2;4;Starker Schneefall;-1;-2;0
29.12.2020 23:00;5;1;4;Leichter Schneefall;-2;-3;0
30.12.2020 00:00;6;3;3;Leichter Schneefall;-2;-4;0
30.12.2020 01:00;2;2;0;Leichter Schneefall;-1;-3;0
30.12.2020 02:00;2;2;0;Stellenweise mäßiger Schneefall;0;-2;0
30.12.2020 03:00;3;0;3;Stellenweise mäßiger Schneefall;0;-1;0
30.12.2020 04:00;4;2;2;Stellenweise mäßiger Schneefall;0;-1;0
30.12.2020 05:00;23;15;8;Leichter Schneefall;0;-1;1
30.12.2020 06:00;45;29;16;Leichter Schneefall;0;-1;1
30.12.2020 07:00;100;63;37;Leichter Schneefall;1;-1;0
30.12.2020 08:00;129;75;54;Mäßiger Schneefall;1;-1;0
30.12.2020 09:00;142;71;71;Mäßiger Schneefall;1;-1;0
30.12.2020 10:00;211;108;103;Mäßiger Schneefall;2;0;0
30.12.2020 11:00;284;131;153;Leichter Schneefall;2;0;0
30.12.2020 12:00;317;137;180;Leichter Schneefall;3;1;0
30.12.2020 13:00;328;141;187;Leichter Schneefall;2;0;0
30.12.2020 14:00;335;174;161;Leichter Schneefall;2;0;0
30.12.2020 15:00;373;189;184;Leichter Schneefall;1;-1;0
30.12.2020 16:00;330;148;182;Leichter Schneefall;1;-1;0
30.12.2020 17:00;253;113;140;Leichte Schneeschauer;0;-2;0
30.12.2020 18:00;189;73;116;Leichte Schneeschauer;0;-3;0
30.12.2020 19:00;209;100;109;Leichte Schneeschauer;-1;-3;0
30.12.2020 20:00;59;21;38;Leichte Schneeschauer;-1;-3;0
30.12.2020 21:00;12;5;7;Leichte Schneeschauer;-1;-4;0
30.12.2020 22:00;14;5;9;Leichte Schneeschauer;-1;-4;0
30.12.2020 23:00;3;3;0;Stellenweise mäßiger Schneefall;-1;-4;1
31.12.2020 00:00;5;3;2;Stellenweise mäßiger Schneefall;-1;-3;1
31.12.2020 01:00;5;4;1;Stellenweise mäßiger Schneefall;-1;-3;0
31.12.2020 02:00;3;2;1;Stellenweise mäßiger Schneefall;-2;-3;0
31.12.2020 03:00;3;0;3;Stellenweise mäßiger Schneefall;-2;-4;0
31.12.2020 04:00;5;2;3;Stellenweise mäßiger Schneefall;-2;-4;0
31.12.2020 05:00;18;11;7;Leicht bewölkt;-3;-5;0
31.12.2020 06:00;26;15;11;Leicht bewölkt;-3;-6;0
31.12.2020 07:00;47;28;19;Leicht bewölkt;-3;-5;0
31.12.2020 08:00;83;48;35;Leicht bewölkt;-2;-5;0
31.12.2020 09:00;163;92;71;Leicht bewölkt;-2;-4;0
31.12.2020 10:00;268;151;117;Leicht bewölkt;-1;-2;0
31.12.2020 11:00;301;133;168;Leicht bewölkt;0;-1;0
31.12.2020 12:00;295;128;167;Leicht bewölkt;1;1;0
31.12.2020 13:00;269;108;161;Leicht bewölkt;1;0;0
31.12.2020 14:00;250;112;138;Bedeckt;1;0;0
31.12.2020 15:00;236;125;111;Bedeckt;1;0;0
31.12.2020 16:00;225;120;105;Bedeckt;0;-1;0
31.12.2020 17:00;151;79;72;Leicht bewölkt;0;-2;0
31.12.2020 18:00;137;62;75;Leicht bewölkt;-1;-3;0
31.12.2020 19:00;174;106;68;Leicht bewölkt;-1;-3;0
31.12.2020 20:00;32;16;16;Bedeckt;-2;-3;0
31.12.2020 21:00;13;10;3;Bedeckt;-2;-3;0
31.12.2020 22:00;11;4;7;Bedeckt;-2;-3;0
31.12.2020 23:00;5;5;0;Leichter Schneefall;-1;-3;0
01.01.2021 00:00;4;2;2;Leichter Schneefall;-1;-3;0
